,n,L,total_attempts,total_successes,total_collisions,collision_rate,success_rate,throughput,per_node
0,20,1,6710,3588,3122,0.46527570789865874,0.5347242921013413,0.3588,"[{'tx': 286, 'success': 155, 'collisions': 131}, {'tx': 445, 'success': 247, 'collisions': 198}, {'tx': 375, 'success': 207, 'collisions': 168}, {'tx': 170, 'success': 81, 'collisions': 89}, {'tx': 260, 'success': 134, 'collisions': 126}, {'tx': 205, 'success': 114, 'collisions': 91}, {'tx': 98, 'success': 42, 'collisions': 56}, {'tx': 359, 'success': 192, 'collisions': 167}, {'tx': 340, 'success': 176, 'collisions': 164}, {'tx': 445, 'success': 252, 'collisions': 193}, {'tx': 284, 'success': 150, 'collisions': 134}, {'tx': 389, 'success': 193, 'collisions': 196}, {'tx': 489, 'success': 273, 'collisions': 216}, {'tx': 185, 'success': 103, 'collisions': 82}, {'tx': 341, 'success': 188, 'collisions': 153}, {'tx': 483, 'success': 254, 'collisions': 229}, {'tx': 524, 'success': 283, 'collisions': 241}, {'tx': 308, 'success': 163, 'collisions': 145}, {'tx': 324, 'success': 171, 'collisions': 153}, {'tx': 400, 'success': 210, 'collisions': 190}]"
1,20,2,4525,2326,2199,0.48596685082872926,0.5140331491712707,0.4652,"[{'tx': 337, 'success': 181, 'collisions': 156}, {'tx': 187, 'success': 94, 'collisions': 93}, {'tx': 270, 'success': 136, 'collisions': 134}, {'tx': 215, 'success': 104, 'collisions': 111}, {'tx': 212, 'success': 112, 'collisions': 100}, {'tx': 260, 'success': 136, 'collisions': 124}, {'tx': 160, 'success': 79, 'collisions': 81}, {'tx': 238, 'success': 116, 'collisions': 122}, {'tx': 349, 'success': 191, 'collisions': 158}, {'tx': 161, 'success': 81, 'collisions': 80}, {'tx': 147, 'success': 77, 'collisions': 70}, {'tx': 90, 'success': 37, 'collisions': 53}, {'tx': 309, 'success': 163, 'collisions': 146}, {'tx': 171, 'success': 73, 'collisions': 98}, {'tx': 213, 'success': 116, 'collisions': 97}, {'tx': 267, 'success': 136, 'collisions': 131}, {'tx': 198, 'success': 107, 'collisions': 91}, {'tx': 237, 'success': 134, 'collisions': 103}, {'tx': 202, 'success': 98, 'collisions': 104}, {'tx': 302, 'success': 155, 'collisions': 147}]"
2,20,3,3446,1743,1703,0.4941961694718514,0.5058038305281486,0.5229,"[{'tx': 94, 'success': 45, 'collisions': 49}, {'tx': 263, 'success': 146, 'collisions': 117}, {'tx': 234, 'success': 124, 'collisions': 110}, {'tx': 244, 'success': 123, 'collisions': 121}, {'tx': 215, 'success': 116, 'collisions': 99}, {'tx': 169, 'success': 90, 'collisions': 79}, {'tx': 139, 'success': 65, 'collisions': 74}, {'tx': 141, 'success': 71, 'collisions': 70}, {'tx': 207, 'success': 97, 'collisions': 110}, {'tx': 119, 'success': 52, 'collisions': 67}, {'tx': 208, 'success': 120, 'collisions': 88}, {'tx': 229, 'success': 133, 'collisions': 96}, {'tx': 153, 'success': 70, 'collisions': 83}, {'tx': 207, 'success': 99, 'collisions': 108}, {'tx': 70, 'success': 30, 'collisions': 40}, {'tx': 164, 'success': 77, 'collisions': 87}, {'tx': 252, 'success': 133, 'collisions': 119}, {'tx': 119, 'success': 49, 'collisions': 70}, {'tx': 159, 'success': 82, 'collisions': 77}, {'tx': 60, 'success': 21, 'collisions': 39}]"
3,20,4,2738,1448,1290,0.47114682249817386,0.5288531775018261,0.5792,"[{'tx': 69, 'success': 35, 'collisions': 34}, {'tx': 241, 'success': 151, 'collisions': 90}, {'tx': 129, 'success': 62, 'collisions': 67}, {'tx': 120, 'success': 67, 'collisions': 53}, {'tx': 90, 'success': 39, 'collisions': 51}, {'tx': 100, 'success': 49, 'collisions': 51}, {'tx': 146, 'success': 76, 'collisions': 70}, {'tx': 132, 'success': 67, 'collisions': 65}, {'tx': 80, 'success': 37, 'collisions': 43}, {'tx': 184, 'success': 94, 'collisions': 90}, {'tx': 165, 'success': 91, 'collisions': 74}, {'tx': 110, 'success': 51, 'collisions': 59}, {'tx': 173, 'success': 94, 'collisions': 79}, {'tx': 107, 'success': 57, 'collisions': 50}, {'tx': 164, 'success': 85, 'collisions': 79}, {'tx': 236, 'success': 139, 'collisions': 97}, {'tx': 178, 'success': 96, 'collisions': 82}, {'tx': 108, 'success': 53, 'collisions': 55}, {'tx': 73, 'success': 39, 'collisions': 34}, {'tx': 133, 'success': 66, 'collisions': 67}]"
4,20,5,2325,1190,1135,0.4881720430107527,0.5118279569892473,0.595,"[{'tx': 146, 'success': 80, 'collisions': 66}, {'tx': 74, 'success': 33, 'collisions': 41}, {'tx': 165, 'success': 89, 'collisions': 76}, {'tx': 121, 'success': 66, 'collisions': 55}, {'tx': 193, 'success': 112, 'collisions': 81}, {'tx': 127, 'success': 66, 'collisions': 61}, {'tx': 32, 'success': 9, 'collisions': 23}, {'tx': 121, 'success': 60, 'collisions': 61}, {'tx': 102, 'success': 49, 'collisions': 53}, {'tx': 116, 'success': 56, 'collisions': 60}, {'tx': 65, 'success': 31, 'collisions': 34}, {'tx': 89, 'success': 38, 'collisions': 51}, {'tx': 66, 'success': 29, 'collisions': 37}, {'tx': 155, 'success': 77, 'collisions': 78}, {'tx': 135, 'success': 64, 'collisions': 71}, {'tx': 103, 'success': 57, 'collisions': 46}, {'tx': 195, 'success': 109, 'collisions': 86}, {'tx': 135, 'success': 64, 'collisions': 71}, {'tx': 34, 'success': 19, 'collisions': 15}, {'tx': 151, 'success': 82, 'collisions': 69}]"
5,20,6,1991,998,993,0.49874434957307884,0.5012556504269211,0.5988,"[{'tx': 41, 'success': 21, 'collisions': 20}, {'tx': 108, 'success': 62, 'collisions': 46}, {'tx': 168, 'success': 98, 'collisions': 70}, {'tx': 99, 'success': 50, 'collisions': 49}, {'tx': 108, 'success': 49, 'collisions': 59}, {'tx': 124, 'success': 73, 'collisions': 51}, {'tx': 72, 'success': 33, 'collisions': 39}, {'tx': 111, 'success': 59, 'collisions': 52}, {'tx': 104, 'success': 46, 'collisions': 58}, {'tx': 127, 'success': 60, 'collisions': 67}, {'tx': 32, 'success': 11, 'collisions': 21}, {'tx': 145, 'success': 73, 'collisions': 72}, {'tx': 106, 'success': 51, 'collisions': 55}, {'tx': 143, 'success': 79, 'collisions': 64}, {'tx': 26, 'success': 10, 'collisions': 16}, {'tx': 125, 'success': 60, 'collisions': 65}, {'tx': 100, 'success': 53, 'collisions': 47}, {'tx': 49, 'success': 21, 'collisions': 28}, {'tx': 83, 'success': 35, 'collisions': 48}, {'tx': 120, 'success': 54, 'collisions': 66}]"
6,20,7,1771,875,896,0.5059288537549407,0.49407114624505927,0.6125,"[{'tx': 75, 'success': 37, 'collisions': 38}, {'tx': 99, 'success': 48, 'collisions': 51}, {'tx': 64, 'success': 28, 'collisions': 36}, {'tx': 36, 'success': 10, 'collisions': 26}, {'tx': 34, 'success': 12, 'collisions': 22}, {'tx': 79, 'success': 37, 'collisions': 42}, {'tx': 84, 'success': 44, 'collisions': 40}, {'tx': 86, 'success': 39, 'collisions': 47}, {'tx': 77, 'success': 33, 'collisions': 44}, {'tx': 97, 'success': 47, 'collisions': 50}, {'tx': 137, 'success': 75, 'collisions': 62}, {'tx': 63, 'success': 25, 'collisions': 38}, {'tx': 56, 'success': 26, 'collisions': 30}, {'tx': 134, 'success': 77, 'collisions': 57}, {'tx': 106, 'success': 52, 'collisions': 54}, {'tx': 139, 'success': 71, 'collisions': 68}, {'tx': 104, 'success': 59, 'collisions': 45}, {'tx': 98, 'success': 50, 'collisions': 48}, {'tx': 114, 'success': 59, 'collisions': 55}, {'tx': 89, 'success': 46, 'collisions': 43}]"
7,20,8,1572,767,805,0.5120865139949109,0.48791348600508905,0.6136,"[{'tx': 90, 'success': 45, 'collisions': 45}, {'tx': 34, 'success': 15, 'collisions': 19}, {'tx': 63, 'success': 30, 'collisions': 33}, {'tx': 87, 'success': 38, 'collisions': 49}, {'tx': 99, 'success': 54, 'collisions': 45}, {'tx': 70, 'success': 32, 'collisions': 38}, {'tx': 28, 'success': 9, 'collisions': 19}, {'tx': 60, 'success': 29, 'collisions': 31}, {'tx': 101, 'success': 55, 'collisions': 46}, {'tx': 93, 'success': 40, 'collisions': 53}, {'tx': 100, 'success': 52, 'collisions': 48}, {'tx': 67, 'success': 30, 'collisions': 37}, {'tx': 74, 'success': 34, 'collisions': 40}, {'tx': 69, 'success': 32, 'collisions': 37}, {'tx': 17, 'success': 5, 'collisions': 12}, {'tx': 88, 'success': 42, 'collisions': 46}, {'tx': 92, 'success': 46, 'collisions': 46}, {'tx': 105, 'success': 55, 'collisions': 50}, {'tx': 106, 'success': 54, 'collisions': 52}, {'tx': 129, 'success': 70, 'collisions': 59}]"
8,20,9,1400,705,695,0.49642857142857144,0.5035714285714286,0.6345,"[{'tx': 53, 'success': 20, 'collisions': 33}, {'tx': 65, 'success': 32, 'collisions': 33}, {'tx': 81, 'success': 45, 'collisions': 36}, {'tx': 109, 'success': 62, 'collisions': 47}, {'tx': 120, 'success': 67, 'collisions': 53}, {'tx': 75, 'success': 33, 'collisions': 42}, {'tx': 77, 'success': 45, 'collisions': 32}, {'tx': 61, 'success': 27, 'collisions': 34}, {'tx': 85, 'success': 43, 'collisions': 42}, {'tx': 84, 'success': 37, 'collisions': 47}, {'tx': 105, 'success': 54, 'collisions': 51}, {'tx': 64, 'success': 28, 'collisions': 36}, {'tx': 13, 'success': 2, 'collisions': 11}, {'tx': 35, 'success': 11, 'collisions': 24}, {'tx': 49, 'success': 22, 'collisions': 27}, {'tx': 69, 'success': 37, 'collisions': 32}, {'tx': 108, 'success': 68, 'collisions': 40}, {'tx': 31, 'success': 14, 'collisions': 17}, {'tx': 15, 'success': 3, 'collisions': 12}, {'tx': 101, 'success': 55, 'collisions': 46}]"
9,20,10,1261,633,628,0.4980174464710547,0.5019825535289453,0.633,"[{'tx': 8, 'success': 0, 'collisions': 8}, {'tx': 63, 'success': 33, 'collisions': 30}, {'tx': 88, 'success': 55, 'collisions': 33}, {'tx': 28, 'success': 11, 'collisions': 17}, {'tx': 93, 'success': 49, 'collisions': 44}, {'tx': 18, 'success': 3, 'collisions': 15}, {'tx': 10, 'success': 1, 'collisions': 9}, {'tx': 57, 'success': 34, 'collisions': 23}, {'tx': 70, 'success': 34, 'collisions': 36}, {'tx': 64, 'success': 28, 'collisions': 36}, {'tx': 89, 'success': 46, 'collisions': 43}, {'tx': 79, 'success': 40, 'collisions': 39}, {'tx': 98, 'success': 51, 'collisions': 47}, {'tx': 67, 'success': 35, 'collisions': 32}, {'tx': 79, 'success': 41, 'collisions': 38}, {'tx': 50, 'success': 23, 'collisions': 27}, {'tx': 84, 'success': 38, 'collisions': 46}, {'tx': 71, 'success': 38, 'collisions': 33}, {'tx': 66, 'success': 28, 'collisions': 38}, {'tx': 79, 'success': 45, 'collisions': 34}]"
10,20,11,1154,588,566,0.4904679376083189,0.5095320623916811,0.6468,"[{'tx': 13, 'success': 5, 'collisions': 8}, {'tx': 63, 'success': 30, 'collisions': 33}, {'tx': 75, 'success': 39, 'collisions': 36}, {'tx': 47, 'success': 24, 'collisions': 23}, {'tx': 79, 'success': 39, 'collisions': 40}, {'tx': 66, 'success': 36, 'collisions': 30}, {'tx': 35, 'success': 13, 'collisions': 22}, {'tx': 13, 'success': 3, 'collisions': 10}, {'tx': 68, 'success': 36, 'collisions': 32}, {'tx': 43, 'success': 17, 'collisions': 26}, {'tx': 117, 'success': 71, 'collisions': 46}, {'tx': 68, 'success': 37, 'collisions': 31}, {'tx': 29, 'success': 10, 'collisions': 19}, {'tx': 52, 'success': 27, 'collisions': 25}, {'tx': 91, 'success': 50, 'collisions': 41}, {'tx': 73, 'success': 40, 'collisions': 33}, {'tx': 74, 'success': 38, 'collisions': 36}, {'tx': 12, 'success': 3, 'collisions': 9}, {'tx': 77, 'success': 47, 'collisions': 30}, {'tx': 59, 'success': 23, 'collisions': 36}]"
11,20,12,1066,536,530,0.4971857410881801,0.5028142589118199,0.6432,"[{'tx': 91, 'success': 53, 'collisions': 38}, {'tx': 77, 'success': 41, 'collisions': 36}, {'tx': 98, 'success': 52, 'collisions': 46}, {'tx': 7, 'success': 0, 'collisions': 7}, {'tx': 21, 'success': 7, 'collisions': 14}, {'tx': 90, 'success': 56, 'collisions': 34}, {'tx': 51, 'success': 25, 'collisions': 26}, {'tx': 9, 'success': 1, 'collisions': 8}, {'tx': 89, 'success': 44, 'collisions': 45}, {'tx': 73, 'success': 37, 'collisions': 36}, {'tx': 43, 'success': 22, 'collisions': 21}, {'tx': 6, 'success': 0, 'collisions': 6}, {'tx': 78, 'success': 43, 'collisions': 35}, {'tx': 7, 'success': 0, 'collisions': 7}, {'tx': 52, 'success': 20, 'collisions': 32}, {'tx': 39, 'success': 21, 'collisions': 18}, {'tx': 36, 'success': 16, 'collisions': 20}, {'tx': 71, 'success': 40, 'collisions': 31}, {'tx': 51, 'success': 20, 'collisions': 31}, {'tx': 77, 'success': 38, 'collisions': 39}]"
12,20,13,1026,498,528,0.5146198830409356,0.4853801169590643,0.6474,"[{'tx': 48, 'success': 20, 'collisions': 28}, {'tx': 59, 'success': 29, 'collisions': 30}, {'tx': 61, 'success': 29, 'collisions': 32}, {'tx': 52, 'success': 22, 'collisions': 30}, {'tx': 79, 'success': 44, 'collisions': 35}, {'tx': 69, 'success': 39, 'collisions': 30}, {'tx': 49, 'success': 22, 'collisions': 27}, {'tx': 41, 'success': 18, 'collisions': 23}, {'tx': 67, 'success': 32, 'collisions': 35}, {'tx': 47, 'success': 23, 'collisions': 24}, {'tx': 67, 'success': 30, 'collisions': 37}, {'tx': 80, 'success': 43, 'collisions': 37}, {'tx': 34, 'success': 18, 'collisions': 16}, {'tx': 31, 'success': 13, 'collisions': 18}, {'tx': 34, 'success': 15, 'collisions': 19}, {'tx': 7, 'success': 0, 'collisions': 7}, {'tx': 11, 'success': 3, 'collisions': 8}, {'tx': 71, 'success': 39, 'collisions': 32}, {'tx': 51, 'success': 30, 'collisions': 21}, {'tx': 68, 'success': 29, 'collisions': 39}]"
13,20,14,953,464,489,0.5131164742917104,0.48688352570828963,0.6496,"[{'tx': 50, 'success': 22, 'collisions': 28}, {'tx': 55, 'success': 23, 'collisions': 32}, {'tx': 53, 'success': 27, 'collisions': 26}, {'tx': 6, 'success': 0, 'collisions': 6}, {'tx': 67, 'success': 37, 'collisions': 30}, {'tx': 20, 'success': 10, 'collisions': 10}, {'tx': 28, 'success': 9, 'collisions': 19}, {'tx': 31, 'success': 9, 'collisions': 22}, {'tx': 79, 'success': 40, 'collisions': 39}, {'tx': 25, 'success': 12, 'collisions': 13}, {'tx': 71, 'success': 38, 'collisions': 33}, {'tx': 59, 'success': 27, 'collisions': 32}, {'tx': 27, 'success': 14, 'collisions': 13}, {'tx': 49, 'success': 24, 'collisions': 25}, {'tx': 77, 'success': 44, 'collisions': 33}, {'tx': 83, 'success': 50, 'collisions': 33}, {'tx': 41, 'success': 19, 'collisions': 22}, {'tx': 50, 'success': 22, 'collisions': 28}, {'tx': 56, 'success': 28, 'collisions': 28}, {'tx': 26, 'success': 9, 'collisions': 17}]"
14,20,15,879,433,446,0.5073947667804323,0.4926052332195677,0.6495,"[{'tx': 55, 'success': 30, 'collisions': 25}, {'tx': 72, 'success': 40, 'collisions': 32}, {'tx': 44, 'success': 17, 'collisions': 27}, {'tx': 43, 'success': 24, 'collisions': 19}, {'tx': 58, 'success': 29, 'collisions': 29}, {'tx': 36, 'success': 16, 'collisions': 20}, {'tx': 10, 'success': 1, 'collisions': 9}, {'tx': 70, 'success': 38, 'collisions': 32}, {'tx': 49, 'success': 25, 'collisions': 24}, {'tx': 59, 'success': 34, 'collisions': 25}, {'tx': 61, 'success': 33, 'collisions': 28}, {'tx': 39, 'success': 15, 'collisions': 24}, {'tx': 50, 'success': 27, 'collisions': 23}, {'tx': 6, 'success': 0, 'collisions': 6}, {'tx': 36, 'success': 19, 'collisions': 17}, {'tx': 49, 'success': 20, 'collisions': 29}, {'tx': 48, 'success': 21, 'collisions': 27}, {'tx': 14, 'success': 3, 'collisions': 11}, {'tx': 27, 'success': 12, 'collisions': 15}, {'tx': 53, 'success': 29, 'collisions': 24}]"
15,20,16,830,398,432,0.5204819277108433,0.4795180722891566,0.6368,"[{'tx': 11, 'success': 4, 'collisions': 7}, {'tx': 33, 'success': 13, 'collisions': 20}, {'tx': 77, 'success': 46, 'collisions': 31}, {'tx': 31, 'success': 13, 'collisions': 18}, {'tx': 58, 'success': 31, 'collisions': 27}, {'tx': 41, 'success': 18, 'collisions': 23}, {'tx': 7, 'success': 0, 'collisions': 7}, {'tx': 40, 'success': 17, 'collisions': 23}, {'tx': 48, 'success': 19, 'collisions': 29}, {'tx': 62, 'success': 33, 'collisions': 29}, {'tx': 25, 'success': 9, 'collisions': 16}, {'tx': 62, 'success': 29, 'collisions': 33}, {'tx': 17, 'success': 6, 'collisions': 11}, {'tx': 58, 'success': 32, 'collisions': 26}, {'tx': 60, 'success': 36, 'collisions': 24}, {'tx': 55, 'success': 27, 'collisions': 28}, {'tx': 52, 'success': 24, 'collisions': 28}, {'tx': 14, 'success': 5, 'collisions': 9}, {'tx': 29, 'success': 12, 'collisions': 17}, {'tx': 50, 'success': 24, 'collisions': 26}]"
16,20,17,793,376,417,0.5258511979823455,0.47414880201765447,0.6392,"[{'tx': 21, 'success': 8, 'collisions': 13}, {'tx': 61, 'success': 30, 'collisions': 31}, {'tx': 37, 'success': 19, 'collisions': 18}, {'tx': 52, 'success': 22, 'collisions': 30}, {'tx': 41, 'success': 21, 'collisions': 20}, {'tx': 41, 'success': 19, 'collisions': 22}, {'tx': 27, 'success': 13, 'collisions': 14}, {'tx': 15, 'success': 6, 'collisions': 9}, {'tx': 45, 'success': 19, 'collisions': 26}, {'tx': 12, 'success': 2, 'collisions': 10}, {'tx': 43, 'success': 23, 'collisions': 20}, {'tx': 66, 'success': 35, 'collisions': 31}, {'tx': 60, 'success': 31, 'collisions': 29}, {'tx': 36, 'success': 13, 'collisions': 23}, {'tx': 68, 'success': 37, 'collisions': 31}, {'tx': 44, 'success': 19, 'collisions': 25}, {'tx': 8, 'success': 1, 'collisions': 7}, {'tx': 61, 'success': 31, 'collisions': 30}, {'tx': 7, 'success': 0, 'collisions': 7}, {'tx': 48, 'success': 27, 'collisions': 21}]"
17,20,18,753,356,397,0.5272244355909694,0.47277556440903057,0.6408,"[{'tx': 11, 'success': 3, 'collisions': 8}, {'tx': 46, 'success': 19, 'collisions': 27}, {'tx': 57, 'success': 30, 'collisions': 27}, {'tx': 42, 'success': 23, 'collisions': 19}, {'tx': 35, 'success': 13, 'collisions': 22}, {'tx': 6, 'success': 0, 'collisions': 6}, {'tx': 47, 'success': 25, 'collisions': 22}, {'tx': 64, 'success': 32, 'collisions': 32}, {'tx': 35, 'success': 14, 'collisions': 21}, {'tx': 43, 'success': 24, 'collisions': 19}, {'tx': 36, 'success': 16, 'collisions': 20}, {'tx': 23, 'success': 8, 'collisions': 15}, {'tx': 41, 'success': 19, 'collisions': 22}, {'tx': 18, 'success': 6, 'collisions': 12}, {'tx': 6, 'success': 0, 'collisions': 6}, {'tx': 72, 'success': 43, 'collisions': 29}, {'tx': 48, 'success': 20, 'collisions': 28}, {'tx': 31, 'success': 12, 'collisions': 19}, {'tx': 51, 'success': 27, 'collisions': 24}, {'tx': 41, 'success': 22, 'collisions': 19}]"
18,20,19,716,333,383,0.5349162011173184,0.4650837988826816,0.6327,"[{'tx': 57, 'success': 30, 'collisions': 27}, {'tx': 39, 'success': 16, 'collisions': 23}, {'tx': 44, 'success': 22, 'collisions': 22}, {'tx': 49, 'success': 27, 'collisions': 22}, {'tx': 44, 'success': 23, 'collisions': 21}, {'tx': 30, 'success': 17, 'collisions': 13}, {'tx': 19, 'success': 7, 'collisions': 12}, {'tx': 33, 'success': 10, 'collisions': 23}, {'tx': 50, 'success': 24, 'collisions': 26}, {'tx': 63, 'success': 42, 'collisions': 21}, {'tx': 33, 'success': 15, 'collisions': 18}, {'tx': 6, 'success': 0, 'collisions': 6}, {'tx': 42, 'success': 17, 'collisions': 25}, {'tx': 28, 'success': 12, 'collisions': 16}, {'tx': 50, 'success': 20, 'collisions': 30}, {'tx': 19, 'success': 5, 'collisions': 14}, {'tx': 33, 'success': 14, 'collisions': 19}, {'tx': 40, 'success': 19, 'collisions': 21}, {'tx': 20, 'success': 7, 'collisions': 13}, {'tx': 17, 'success': 6, 'collisions': 11}]"
19,20,20,689,322,367,0.532656023222061,0.46734397677793904,0.644,"[{'tx': 18, 'success': 5, 'collisions': 13}, {'tx': 55, 'success': 31, 'collisions': 24}, {'tx': 41, 'success': 17, 'collisions': 24}, {'tx': 36, 'success': 16, 'collisions': 20}, {'tx': 35, 'success': 18, 'collisions': 17}, {'tx': 37, 'success': 21, 'collisions': 16}, {'tx': 64, 'success': 35, 'collisions': 29}, {'tx': 46, 'success': 25, 'collisions': 21}, {'tx': 51, 'success': 26, 'collisions': 25}, {'tx': 54, 'success': 29, 'collisions': 25}, {'tx': 30, 'success': 12, 'collisions': 18}, {'tx': 22, 'success': 7, 'collisions': 15}, {'tx': 40, 'success': 19, 'collisions': 21}, {'tx': 21, 'success': 7, 'collisions': 14}, {'tx': 28, 'success': 13, 'collisions': 15}, {'tx': 6, 'success': 1, 'collisions': 5}, {'tx': 38, 'success': 17, 'collisions': 21}, {'tx': 39, 'success': 17, 'collisions': 22}, {'tx': 10, 'success': 2, 'collisions': 8}, {'tx': 18, 'success': 4, 'collisions': 14}]"
20,20,21,651,309,342,0.5253456221198156,0.47465437788018433,0.6489,"[{'tx': 16, 'success': 3, 'collisions': 13}, {'tx': 23, 'success': 8, 'collisions': 15}, {'tx': 51, 'success': 27, 'collisions': 24}, {'tx': 18, 'success': 5, 'collisions': 13}, {'tx': 13, 'success': 6, 'collisions': 7}, {'tx': 37, 'success': 19, 'collisions': 18}, {'tx': 53, 'success': 23, 'collisions': 30}, {'tx': 57, 'success': 34, 'collisions': 23}, {'tx': 14, 'success': 5, 'collisions': 9}, {'tx': 30, 'success': 14, 'collisions': 16}, {'tx': 30, 'success': 12, 'collisions': 18}, {'tx': 34, 'success': 15, 'collisions': 19}, {'tx': 11, 'success': 3, 'collisions': 8}, {'tx': 60, 'success': 33, 'collisions': 27}, {'tx': 53, 'success': 30, 'collisions': 23}, {'tx': 48, 'success': 29, 'collisions': 19}, {'tx': 37, 'success': 17, 'collisions': 20}, {'tx': 20, 'success': 7, 'collisions': 13}, {'tx': 22, 'success': 9, 'collisions': 13}, {'tx': 24, 'success': 10, 'collisions': 14}]"
21,20,22,630,289,341,0.5412698412698412,0.4587301587301587,0.6358,"[{'tx': 46, 'success': 26, 'collisions': 20}, {'tx': 57, 'success': 31, 'collisions': 26}, {'tx': 38, 'success': 14, 'collisions': 24}, {'tx': 19, 'success': 4, 'collisions': 15}, {'tx': 53, 'success': 30, 'collisions': 23}, {'tx': 25, 'success': 9, 'collisions': 16}, {'tx': 43, 'success': 19, 'collisions': 24}, {'tx': 12, 'success': 2, 'collisions': 10}, {'tx': 33, 'success': 16, 'collisions': 17}, {'tx': 32, 'success': 15, 'collisions': 17}, {'tx': 47, 'success': 23, 'collisions': 24}, {'tx': 47, 'success': 28, 'collisions': 19}, {'tx': 6, 'success': 0, 'collisions': 6}, {'tx': 59, 'success': 32, 'collisions': 27}, {'tx': 26, 'success': 11, 'collisions': 15}, {'tx': 6, 'success': 0, 'collisions': 6}, {'tx': 6, 'success': 0, 'collisions': 6}, {'tx': 12, 'success': 3, 'collisions': 9}, {'tx': 25, 'success': 10, 'collisions': 15}, {'tx': 38, 'success': 16, 'collisions': 22}]"
22,20,23,596,270,326,0.5469798657718121,0.45302013422818793,0.621,"[{'tx': 22, 'success': 8, 'collisions': 14}, {'tx': 33, 'success': 16, 'collisions': 17}, {'tx': 46, 'success': 23, 'collisions': 23}, {'tx': 19, 'success': 8, 'collisions': 11}, {'tx': 37, 'success': 19, 'collisions': 18}, {'tx': 30, 'success': 12, 'collisions': 18}, {'tx': 13, 'success': 2, 'collisions': 11}, {'tx': 48, 'success': 25, 'collisions': 23}, {'tx': 35, 'success': 14, 'collisions': 21}, {'tx': 10, 'success': 2, 'collisions': 8}, {'tx': 29, 'success': 15, 'collisions': 14}, {'tx': 29, 'success': 13, 'collisions': 16}, {'tx': 33, 'success': 16, 'collisions': 17}, {'tx': 41, 'success': 20, 'collisions': 21}, {'tx': 18, 'success': 6, 'collisions': 12}, {'tx': 17, 'success': 7, 'collisions': 10}, {'tx': 27, 'success': 12, 'collisions': 15}, {'tx': 28, 'success': 10, 'collisions': 18}, {'tx': 31, 'success': 12, 'collisions': 19}, {'tx': 50, 'success': 30, 'collisions': 20}]"
23,20,24,586,260,326,0.5563139931740614,0.44368600682593856,0.624,"[{'tx': 34, 'success': 14, 'collisions': 20}, {'tx': 39, 'success': 21, 'collisions': 18}, {'tx': 23, 'success': 8, 'collisions': 15}, {'tx': 31, 'success': 15, 'collisions': 16}, {'tx': 42, 'success': 19, 'collisions': 23}, {'tx': 46, 'success': 25, 'collisions': 21}, {'tx': 22, 'success': 9, 'collisions': 13}, {'tx': 12, 'success': 2, 'collisions': 10}, {'tx': 19, 'success': 5, 'collisions': 14}, {'tx': 20, 'success': 7, 'collisions': 13}, {'tx': 24, 'success': 10, 'collisions': 14}, {'tx': 17, 'success': 6, 'collisions': 11}, {'tx': 41, 'success': 22, 'collisions': 19}, {'tx': 53, 'success': 31, 'collisions': 22}, {'tx': 39, 'success': 17, 'collisions': 22}, {'tx': 31, 'success': 13, 'collisions': 18}, {'tx': 41, 'success': 20, 'collisions': 21}, {'tx': 15, 'success': 4, 'collisions': 11}, {'tx': 31, 'success': 12, 'collisions': 19}, {'tx': 6, 'success': 0, 'collisions': 6}]"
24,20,25,565,252,313,0.5539823008849557,0.44601769911504424,0.63,"[{'tx': 16, 'success': 6, 'collisions': 10}, {'tx': 31, 'success': 13, 'collisions': 18}, {'tx': 16, 'success': 5, 'collisions': 11}, {'tx': 14, 'success': 4, 'collisions': 10}, {'tx': 29, 'success': 13, 'collisions': 16}, {'tx': 26, 'success': 11, 'collisions': 15}, {'tx': 11, 'success': 3, 'collisions': 8}, {'tx': 42, 'success': 22, 'collisions': 20}, {'tx': 23, 'success': 8, 'collisions': 15}, {'tx': 40, 'success': 22, 'collisions': 18}, {'tx': 30, 'success': 16, 'collisions': 14}, {'tx': 33, 'success': 16, 'collisions': 17}, {'tx': 40, 'success': 18, 'collisions': 22}, {'tx': 33, 'success': 14, 'collisions': 19}, {'tx': 7, 'success': 1, 'collisions': 6}, {'tx': 26, 'success': 9, 'collisions': 17}, {'tx': 43, 'success': 22, 'collisions': 21}, {'tx': 20, 'success': 6, 'collisions': 14}, {'tx': 37, 'success': 15, 'collisions': 22}, {'tx': 48, 'success': 28, 'collisions': 20}]"
25,20,26,539,246,293,0.5435992578849722,0.45640074211502785,0.6396,"[{'tx': 6, 'success': 0, 'collisions': 6}, {'tx': 42, 'success': 25, 'collisions': 17}, {'tx': 14, 'success': 3, 'collisions': 11}, {'tx': 25, 'success': 10, 'collisions': 15}, {'tx': 27, 'success': 10, 'collisions': 17}, {'tx': 20, 'success': 5, 'collisions': 15}, {'tx': 15, 'success': 5, 'collisions': 10}, {'tx': 33, 'success': 14, 'collisions': 19}, {'tx': 25, 'success': 12, 'collisions': 13}, {'tx': 38, 'success': 20, 'collisions': 18}, {'tx': 23, 'success': 10, 'collisions': 13}, {'tx': 27, 'success': 11, 'collisions': 16}, {'tx': 31, 'success': 17, 'collisions': 14}, {'tx': 8, 'success': 1, 'collisions': 7}, {'tx': 32, 'success': 17, 'collisions': 15}, {'tx': 27, 'success': 13, 'collisions': 14}, {'tx': 28, 'success': 11, 'collisions': 17}, {'tx': 37, 'success': 17, 'collisions': 20}, {'tx': 35, 'success': 20, 'collisions': 15}, {'tx': 46, 'success': 25, 'collisions': 21}]"
26,20,27,523,235,288,0.5506692160611855,0.44933078393881454,0.6345,"[{'tx': 29, 'success': 12, 'collisions': 17}, {'tx': 5, 'success': 0, 'collisions': 5}, {'tx': 12, 'success': 3, 'collisions': 9}, {'tx': 29, 'success': 11, 'collisions': 18}, {'tx': 22, 'success': 9, 'collisions': 13}, {'tx': 37, 'success': 17, 'collisions': 20}, {'tx': 24, 'success': 11, 'collisions': 13}, {'tx': 42, 'success': 19, 'collisions': 23}, {'tx': 36, 'success': 18, 'collisions': 18}, {'tx': 15, 'success': 4, 'collisions': 11}, {'tx': 29, 'success': 14, 'collisions': 15}, {'tx': 11, 'success': 4, 'collisions': 7}, {'tx': 33, 'success': 17, 'collisions': 16}, {'tx': 46, 'success': 28, 'collisions': 18}, {'tx': 38, 'success': 21, 'collisions': 17}, {'tx': 20, 'success': 9, 'collisions': 11}, {'tx': 25, 'success': 9, 'collisions': 16}, {'tx': 12, 'success': 4, 'collisions': 8}, {'tx': 24, 'success': 9, 'collisions': 15}, {'tx': 34, 'success': 16, 'collisions': 18}]"
27,20,28,508,227,281,0.5531496062992126,0.4468503937007874,0.6356,"[{'tx': 22, 'success': 6, 'collisions': 16}, {'tx': 8, 'success': 1, 'collisions': 7}, {'tx': 17, 'success': 4, 'collisions': 13}, {'tx': 21, 'success': 9, 'collisions': 12}, {'tx': 37, 'success': 17, 'collisions': 20}, {'tx': 32, 'success': 16, 'collisions': 16}, {'tx': 11, 'success': 5, 'collisions': 6}, {'tx': 27, 'success': 11, 'collisions': 16}, {'tx': 10, 'success': 3, 'collisions': 7}, {'tx': 20, 'success': 7, 'collisions': 13}, {'tx': 47, 'success': 30, 'collisions': 17}, {'tx': 25, 'success': 10, 'collisions': 15}, {'tx': 16, 'success': 7, 'collisions': 9}, {'tx': 30, 'success': 11, 'collisions': 19}, {'tx': 17, 'success': 6, 'collisions': 11}, {'tx': 30, 'success': 12, 'collisions': 18}, {'tx': 48, 'success': 25, 'collisions': 23}, {'tx': 6, 'success': 0, 'collisions': 6}, {'tx': 34, 'success': 18, 'collisions': 16}, {'tx': 50, 'success': 29, 'collisions': 21}]"
28,20,29,496,216,280,0.5645161290322581,0.43548387096774194,0.6264,"[{'tx': 20, 'success': 7, 'collisions': 13}, {'tx': 21, 'success': 11, 'collisions': 10}, {'tx': 9, 'success': 1, 'collisions': 8}, {'tx': 40, 'success': 24, 'collisions': 16}, {'tx': 40, 'success': 23, 'collisions': 17}, {'tx': 10, 'success': 1, 'collisions': 9}, {'tx': 31, 'success': 15, 'collisions': 16}, {'tx': 24, 'success': 11, 'collisions': 13}, {'tx': 27, 'success': 11, 'collisions': 16}, {'tx': 31, 'success': 14, 'collisions': 17}, {'tx': 17, 'success': 5, 'collisions': 12}, {'tx': 18, 'success': 6, 'collisions': 12}, {'tx': 30, 'success': 14, 'collisions': 16}, {'tx': 30, 'success': 12, 'collisions': 18}, {'tx': 19, 'success': 5, 'collisions': 14}, {'tx': 25, 'success': 11, 'collisions': 14}, {'tx': 22, 'success': 9, 'collisions': 13}, {'tx': 30, 'success': 14, 'collisions': 16}, {'tx': 36, 'success': 18, 'collisions': 18}, {'tx': 16, 'success': 4, 'collisions': 12}]"
29,20,30,475,222,253,0.5326315789473685,0.4673684210526316,0.666,"[{'tx': 16, 'success': 5, 'collisions': 11}, {'tx': 13, 'success': 4, 'collisions': 9}, {'tx': 35, 'success': 16, 'collisions': 19}, {'tx': 24, 'success': 10, 'collisions': 14}, {'tx': 42, 'success': 24, 'collisions': 18}, {'tx': 24, 'success': 11, 'collisions': 13}, {'tx': 19, 'success': 7, 'collisions': 12}, {'tx': 38, 'success': 21, 'collisions': 17}, {'tx': 5, 'success': 0, 'collisions': 5}, {'tx': 20, 'success': 9, 'collisions': 11}, {'tx': 32, 'success': 19, 'collisions': 13}, {'tx': 18, 'success': 6, 'collisions': 12}, {'tx': 18, 'success': 7, 'collisions': 11}, {'tx': 32, 'success': 16, 'collisions': 16}, {'tx': 24, 'success': 12, 'collisions': 12}, {'tx': 6, 'success': 0, 'collisions': 6}, {'tx': 32, 'success': 17, 'collisions': 15}, {'tx': 17, 'success': 5, 'collisions': 12}, {'tx': 35, 'success': 23, 'collisions': 12}, {'tx': 25, 'success': 10, 'collisions': 15}]"
30,20,31,452,203,249,0.5508849557522124,0.4491150442477876,0.6293,"[{'tx': 42, 'success': 22, 'collisions': 20}, {'tx': 5, 'success': 0, 'collisions': 5}, {'tx': 37, 'success': 18, 'collisions': 19}, {'tx': 17, 'success': 9, 'collisions': 8}, {'tx': 23, 'success': 10, 'collisions': 13}, {'tx': 37, 'success': 18, 'collisions': 19}, {'tx': 25, 'success': 10, 'collisions': 15}, {'tx': 10, 'success': 4, 'collisions': 6}, {'tx': 14, 'success': 4, 'collisions': 10}, {'tx': 43, 'success': 21, 'collisions': 22}, {'tx': 41, 'success': 22, 'collisions': 19}, {'tx': 26, 'success': 14, 'collisions': 12}, {'tx': 31, 'success': 16, 'collisions': 15}, {'tx': 6, 'success': 0, 'collisions': 6}, {'tx': 18, 'success': 6, 'collisions': 12}, {'tx': 9, 'success': 2, 'collisions': 7}, {'tx': 11, 'success': 3, 'collisions': 8}, {'tx': 24, 'success': 11, 'collisions': 13}, {'tx': 8, 'success': 2, 'collisions': 6}, {'tx': 25, 'success': 11, 'collisions': 14}]"
31,20,32,447,200,247,0.5525727069351231,0.44742729306487694,0.64,"[{'tx': 37, 'success': 26, 'collisions': 11}, {'tx': 16, 'success': 7, 'collisions': 9}, {'tx': 33, 'success': 17, 'collisions': 16}, {'tx': 19, 'success': 8, 'collisions': 11}, {'tx': 17, 'success': 6, 'collisions': 11}, {'tx': 29, 'success': 13, 'collisions': 16}, {'tx': 23, 'success': 10, 'collisions': 13}, {'tx': 10, 'success': 1, 'collisions': 9}, {'tx': 6, 'success': 0, 'collisions': 6}, {'tx': 25, 'success': 13, 'collisions': 12}, {'tx': 11, 'success': 3, 'collisions': 8}, {'tx': 38, 'success': 21, 'collisions': 17}, {'tx': 22, 'success': 8, 'collisions': 14}, {'tx': 6, 'success': 0, 'collisions': 6}, {'tx': 28, 'success': 12, 'collisions': 16}, {'tx': 32, 'success': 15, 'collisions': 17}, {'tx': 12, 'success': 2, 'collisions': 10}, {'tx': 25, 'success': 12, 'collisions': 13}, {'tx': 26, 'success': 12, 'collisions': 14}, {'tx': 32, 'success': 14, 'collisions': 18}]"
32,20,33,419,203,216,0.5155131264916468,0.48448687350835323,0.6699,"[{'tx': 29, 'success': 14, 'collisions': 15}, {'tx': 31, 'success': 15, 'collisions': 16}, {'tx': 37, 'success': 20, 'collisions': 17}, {'tx': 26, 'success': 14, 'collisions': 12}, {'tx': 12, 'success': 5, 'collisions': 7}, {'tx': 20, 'success': 11, 'collisions': 9}, {'tx': 25, 'success': 12, 'collisions': 13}, {'tx': 9, 'success': 3, 'collisions': 6}, {'tx': 30, 'success': 15, 'collisions': 15}, {'tx': 33, 'success': 16, 'collisions': 17}, {'tx': 12, 'success': 3, 'collisions': 9}, {'tx': 9, 'success': 1, 'collisions': 8}, {'tx': 7, 'success': 1, 'collisions': 6}, {'tx': 17, 'success': 9, 'collisions': 8}, {'tx': 8, 'success': 3, 'collisions': 5}, {'tx': 38, 'success': 22, 'collisions': 16}, {'tx': 5, 'success': 0, 'collisions': 5}, {'tx': 24, 'success': 13, 'collisions': 11}, {'tx': 30, 'success': 19, 'collisions': 11}, {'tx': 17, 'success': 7, 'collisions': 10}]"
33,20,34,427,189,238,0.5573770491803278,0.4426229508196721,0.6426,"[{'tx': 17, 'success': 8, 'collisions': 9}, {'tx': 20, 'success': 6, 'collisions': 14}, {'tx': 25, 'success': 10, 'collisions': 15}, {'tx': 26, 'success': 14, 'collisions': 12}, {'tx': 15, 'success': 6, 'collisions': 9}, {'tx': 27, 'success': 14, 'collisions': 13}, {'tx': 14, 'success': 4, 'collisions': 10}, {'tx': 32, 'success': 16, 'collisions': 16}, {'tx': 35, 'success': 20, 'collisions': 15}, {'tx': 11, 'success': 3, 'collisions': 8}, {'tx': 24, 'success': 9, 'collisions': 15}, {'tx': 11, 'success': 2, 'collisions': 9}, {'tx': 32, 'success': 18, 'collisions': 14}, {'tx': 28, 'success': 16, 'collisions': 12}, {'tx': 9, 'success': 1, 'collisions': 8}, {'tx': 17, 'success': 9, 'collisions': 8}, {'tx': 19, 'success': 8, 'collisions': 11}, {'tx': 10, 'success': 2, 'collisions': 8}, {'tx': 28, 'success': 14, 'collisions': 14}, {'tx': 27, 'success': 9, 'collisions': 18}]"
34,20,35,415,176,239,0.5759036144578313,0.42409638554216866,0.616,"[{'tx': 15, 'success': 6, 'collisions': 9}, {'tx': 20, 'success': 7, 'collisions': 13}, {'tx': 30, 'success': 15, 'collisions': 15}, {'tx': 26, 'success': 12, 'collisions': 14}, {'tx': 38, 'success': 17, 'collisions': 21}, {'tx': 27, 'success': 12, 'collisions': 15}, {'tx': 13, 'success': 5, 'collisions': 8}, {'tx': 11, 'success': 3, 'collisions': 8}, {'tx': 21, 'success': 8, 'collisions': 13}, {'tx': 6, 'success': 0, 'collisions': 6}, {'tx': 16, 'success': 7, 'collisions': 9}, {'tx': 21, 'success': 11, 'collisions': 10}, {'tx': 31, 'success': 18, 'collisions': 13}, {'tx': 7, 'success': 1, 'collisions': 6}, {'tx': 31, 'success': 17, 'collisions': 14}, {'tx': 15, 'success': 3, 'collisions': 12}, {'tx': 24, 'success': 10, 'collisions': 14}, {'tx': 37, 'success': 18, 'collisions': 19}, {'tx': 10, 'success': 2, 'collisions': 8}, {'tx': 16, 'success': 4, 'collisions': 12}]"
35,20,36,393,171,222,0.5648854961832062,0.4351145038167939,0.6156,"[{'tx': 33, 'success': 15, 'collisions': 18}, {'tx': 36, 'success': 19, 'collisions': 17}, {'tx': 6, 'success': 1, 'collisions': 5}, {'tx': 15, 'success': 5, 'collisions': 10}, {'tx': 23, 'success': 10, 'collisions': 13}, {'tx': 16, 'success': 8, 'collisions': 8}, {'tx': 15, 'success': 5, 'collisions': 10}, {'tx': 6, 'success': 0, 'collisions': 6}, {'tx': 14, 'success': 5, 'collisions': 9}, {'tx': 38, 'success': 21, 'collisions': 17}, {'tx': 7, 'success': 0, 'collisions': 7}, {'tx': 23, 'success': 12, 'collisions': 11}, {'tx': 18, 'success': 7, 'collisions': 11}, {'tx': 21, 'success': 10, 'collisions': 11}, {'tx': 7, 'success': 1, 'collisions': 6}, {'tx': 28, 'success': 14, 'collisions': 14}, {'tx': 18, 'success': 7, 'collisions': 11}, {'tx': 35, 'success': 18, 'collisions': 17}, {'tx': 7, 'success': 0, 'collisions': 7}, {'tx': 27, 'success': 13, 'collisions': 14}]"
36,20,37,384,176,208,0.5416666666666666,0.4583333333333333,0.6512,"[{'tx': 10, 'success': 2, 'collisions': 8}, {'tx': 20, 'success': 10, 'collisions': 10}, {'tx': 27, 'success': 15, 'collisions': 12}, {'tx': 28, 'success': 17, 'collisions': 11}, {'tx': 23, 'success': 13, 'collisions': 10}, {'tx': 21, 'success': 8, 'collisions': 13}, {'tx': 19, 'success': 10, 'collisions': 9}, {'tx': 5, 'success': 0, 'collisions': 5}, {'tx': 10, 'success': 3, 'collisions': 7}, {'tx': 5, 'success': 0, 'collisions': 5}, {'tx': 20, 'success': 9, 'collisions': 11}, {'tx': 24, 'success': 12, 'collisions': 12}, {'tx': 24, 'success': 10, 'collisions': 14}, {'tx': 34, 'success': 20, 'collisions': 14}, {'tx': 21, 'success': 7, 'collisions': 14}, {'tx': 18, 'success': 7, 'collisions': 11}, {'tx': 26, 'success': 13, 'collisions': 13}, {'tx': 13, 'success': 4, 'collisions': 9}, {'tx': 21, 'success': 8, 'collisions': 13}, {'tx': 15, 'success': 8, 'collisions': 7}]"
37,20,38,365,173,192,0.5260273972602739,0.473972602739726,0.6574,"[{'tx': 13, 'success': 5, 'collisions': 8}, {'tx': 11, 'success': 2, 'collisions': 9}, {'tx': 19, 'success': 11, 'collisions': 8}, {'tx': 14, 'success': 6, 'collisions': 8}, {'tx': 25, 'success': 15, 'collisions': 10}, {'tx': 10, 'success': 2, 'collisions': 8}, {'tx': 9, 'success': 1, 'collisions': 8}, {'tx': 6, 'success': 0, 'collisions': 6}, {'tx': 8, 'success': 2, 'collisions': 6}, {'tx': 35, 'success': 21, 'collisions': 14}, {'tx': 39, 'success': 25, 'collisions': 14}, {'tx': 11, 'success': 2, 'collisions': 9}, {'tx': 20, 'success': 11, 'collisions': 9}, {'tx': 14, 'success': 5, 'collisions': 9}, {'tx': 33, 'success': 17, 'collisions': 16}, {'tx': 17, 'success': 7, 'collisions': 10}, {'tx': 33, 'success': 19, 'collisions': 14}, {'tx': 14, 'success': 5, 'collisions': 9}, {'tx': 23, 'success': 14, 'collisions': 9}, {'tx': 11, 'success': 3, 'collisions': 8}]"
38,20,39,366,165,201,0.5491803278688525,0.45081967213114754,0.6435,"[{'tx': 16, 'success': 5, 'collisions': 11}, {'tx': 14, 'success': 6, 'collisions': 8}, {'tx': 18, 'success': 6, 'collisions': 12}, {'tx': 20, 'success': 9, 'collisions': 11}, {'tx': 12, 'success': 6, 'collisions': 6}, {'tx': 20, 'success': 10, 'collisions': 10}, {'tx': 26, 'success': 12, 'collisions': 14}, {'tx': 12, 'success': 5, 'collisions': 7}, {'tx': 30, 'success': 18, 'collisions': 12}, {'tx': 14, 'success': 4, 'collisions': 10}, {'tx': 20, 'success': 10, 'collisions': 10}, {'tx': 16, 'success': 7, 'collisions': 9}, {'tx': 17, 'success': 7, 'collisions': 10}, {'tx': 30, 'success': 15, 'collisions': 15}, {'tx': 17, 'success': 8, 'collisions': 9}, {'tx': 9, 'success': 3, 'collisions': 6}, {'tx': 22, 'success': 11, 'collisions': 11}, {'tx': 9, 'success': 3, 'collisions': 6}, {'tx': 20, 'success': 9, 'collisions': 11}, {'tx': 24, 'success': 11, 'collisions': 13}]"
39,20,40,365,157,208,0.5698630136986301,0.4301369863013699,0.628,"[{'tx': 16, 'success': 4, 'collisions': 12}, {'tx': 32, 'success': 21, 'collisions': 11}, {'tx': 11, 'success': 4, 'collisions': 7}, {'tx': 14, 'success': 4, 'collisions': 10}, {'tx': 21, 'success': 8, 'collisions': 13}, {'tx': 30, 'success': 15, 'collisions': 15}, {'tx': 12, 'success': 4, 'collisions': 8}, {'tx': 7, 'success': 1, 'collisions': 6}, {'tx': 16, 'success': 6, 'collisions': 10}, {'tx': 30, 'success': 14, 'collisions': 16}, {'tx': 5, 'success': 0, 'collisions': 5}, {'tx': 24, 'success': 12, 'collisions': 12}, {'tx': 15, 'success': 6, 'collisions': 9}, {'tx': 11, 'success': 2, 'collisions': 9}, {'tx': 7, 'success': 1, 'collisions': 6}, {'tx': 18, 'success': 6, 'collisions': 12}, {'tx': 40, 'success': 25, 'collisions': 15}, {'tx': 27, 'success': 12, 'collisions': 15}, {'tx': 19, 'success': 9, 'collisions': 10}, {'tx': 10, 'success': 3, 'collisions': 7}]"
40,20,41,355,158,197,0.5549295774647888,0.4450704225352113,0.6478,"[{'tx': 22, 'success': 12, 'collisions': 10}, {'tx': 25, 'success': 11, 'collisions': 14}, {'tx': 6, 'success': 1, 'collisions': 5}, {'tx': 5, 'success': 0, 'collisions': 5}, {'tx': 24, 'success': 11, 'collisions': 13}, {'tx': 26, 'success': 12, 'collisions': 14}, {'tx': 10, 'success': 3, 'collisions': 7}, {'tx': 10, 'success': 3, 'collisions': 7}, {'tx': 26, 'success': 11, 'collisions': 15}, {'tx': 14, 'success': 5, 'collisions': 9}, {'tx': 11, 'success': 2, 'collisions': 9}, {'tx': 20, 'success': 11, 'collisions': 9}, {'tx': 28, 'success': 16, 'collisions': 12}, {'tx': 26, 'success': 14, 'collisions': 12}, {'tx': 21, 'success': 10, 'collisions': 11}, {'tx': 6, 'success': 1, 'collisions': 5}, {'tx': 22, 'success': 10, 'collisions': 12}, {'tx': 26, 'success': 14, 'collisions': 12}, {'tx': 11, 'success': 4, 'collisions': 7}, {'tx': 16, 'success': 7, 'collisions': 9}]"
41,20,42,350,141,209,0.5971428571428572,0.40285714285714286,0.5922,"[{'tx': 5, 'success': 0, 'collisions': 5}, {'tx': 9, 'success': 2, 'collisions': 7}, {'tx': 30, 'success': 15, 'collisions': 15}, {'tx': 30, 'success': 16, 'collisions': 14}, {'tx': 23, 'success': 9, 'collisions': 14}, {'tx': 5, 'success': 0, 'collisions': 5}, {'tx': 17, 'success': 6, 'collisions': 11}, {'tx': 30, 'success': 17, 'collisions': 13}, {'tx': 13, 'success': 6, 'collisions': 7}, {'tx': 23, 'success': 8, 'collisions': 15}, {'tx': 11, 'success': 2, 'collisions': 9}, {'tx': 17, 'success': 7, 'collisions': 10}, {'tx': 7, 'success': 1, 'collisions': 6}, {'tx': 30, 'success': 16, 'collisions': 14}, {'tx': 15, 'success': 6, 'collisions': 9}, {'tx': 14, 'success': 4, 'collisions': 10}, {'tx': 23, 'success': 10, 'collisions': 13}, {'tx': 18, 'success': 6, 'collisions': 12}, {'tx': 17, 'success': 6, 'collisions': 11}, {'tx': 13, 'success': 4, 'collisions': 9}]"
42,20,43,332,146,186,0.5602409638554217,0.4397590361445783,0.6278,"[{'tx': 12, 'success': 5, 'collisions': 7}, {'tx': 12, 'success': 3, 'collisions': 9}, {'tx': 10, 'success': 3, 'collisions': 7}, {'tx': 22, 'success': 12, 'collisions': 10}, {'tx': 28, 'success': 16, 'collisions': 12}, {'tx': 30, 'success': 19, 'collisions': 11}, {'tx': 10, 'success': 2, 'collisions': 8}, {'tx': 24, 'success': 13, 'collisions': 11}, {'tx': 5, 'success': 0, 'collisions': 5}, {'tx': 33, 'success': 20, 'collisions': 13}, {'tx': 30, 'success': 16, 'collisions': 14}, {'tx': 5, 'success': 0, 'collisions': 5}, {'tx': 22, 'success': 7, 'collisions': 15}, {'tx': 20, 'success': 8, 'collisions': 12}, {'tx': 8, 'success': 2, 'collisions': 6}, {'tx': 6, 'success': 1, 'collisions': 5}, {'tx': 13, 'success': 5, 'collisions': 8}, {'tx': 8, 'success': 2, 'collisions': 6}, {'tx': 20, 'success': 8, 'collisions': 12}, {'tx': 14, 'success': 4, 'collisions': 10}]"
43,20,44,322,144,178,0.5527950310559007,0.4472049689440994,0.6336,"[{'tx': 30, 'success': 20, 'collisions': 10}, {'tx': 18, 'success': 10, 'collisions': 8}, {'tx': 15, 'success': 7, 'collisions': 8}, {'tx': 6, 'success': 0, 'collisions': 6}, {'tx': 5, 'success': 0, 'collisions': 5}, {'tx': 10, 'success': 1, 'collisions': 9}, {'tx': 8, 'success': 3, 'collisions': 5}, {'tx': 8, 'success': 2, 'collisions': 6}, {'tx': 16, 'success': 6, 'collisions': 10}, {'tx': 13, 'success': 7, 'collisions': 6}, {'tx': 28, 'success': 17, 'collisions': 11}, {'tx': 19, 'success': 6, 'collisions': 13}, {'tx': 17, 'success': 7, 'collisions': 10}, {'tx': 14, 'success': 5, 'collisions': 9}, {'tx': 18, 'success': 8, 'collisions': 10}, {'tx': 21, 'success': 11, 'collisions': 10}, {'tx': 16, 'success': 7, 'collisions': 9}, {'tx': 20, 'success': 10, 'collisions': 10}, {'tx': 13, 'success': 4, 'collisions': 9}, {'tx': 27, 'success': 13, 'collisions': 14}]"
44,20,45,328,133,195,0.5945121951219512,0.4054878048780488,0.5985,"[{'tx': 26, 'success': 12, 'collisions': 14}, {'tx': 6, 'success': 1, 'collisions': 5}, {'tx': 32, 'success': 16, 'collisions': 16}, {'tx': 13, 'success': 3, 'collisions': 10}, {'tx': 26, 'success': 13, 'collisions': 13}, {'tx': 24, 'success': 12, 'collisions': 12}, {'tx': 8, 'success': 2, 'collisions': 6}, {'tx': 10, 'success': 2, 'collisions': 8}, {'tx': 5, 'success': 0, 'collisions': 5}, {'tx': 18, 'success': 8, 'collisions': 10}, {'tx': 18, 'success': 7, 'collisions': 11}, {'tx': 10, 'success': 3, 'collisions': 7}, {'tx': 7, 'success': 2, 'collisions': 5}, {'tx': 13, 'success': 4, 'collisions': 9}, {'tx': 22, 'success': 10, 'collisions': 12}, {'tx': 12, 'success': 6, 'collisions': 6}, {'tx': 27, 'success': 12, 'collisions': 15}, {'tx': 13, 'success': 5, 'collisions': 8}, {'tx': 17, 'success': 6, 'collisions': 11}, {'tx': 21, 'success': 9, 'collisions': 12}]"
45,20,46,327,136,191,0.5840978593272171,0.41590214067278286,0.6256,"[{'tx': 20, 'success': 9, 'collisions': 11}, {'tx': 5, 'success': 0, 'collisions': 5}, {'tx': 24, 'success': 12, 'collisions': 12}, {'tx': 24, 'success': 14, 'collisions': 10}, {'tx': 5, 'success': 0, 'collisions': 5}, {'tx': 23, 'success': 10, 'collisions': 13}, {'tx': 7, 'success': 2, 'collisions': 5}, {'tx': 18, 'success': 9, 'collisions': 9}, {'tx': 22, 'success': 12, 'collisions': 10}, {'tx': 16, 'success': 6, 'collisions': 10}, {'tx': 4, 'success': 0, 'collisions': 4}, {'tx': 28, 'success': 14, 'collisions': 14}, {'tx': 24, 'success': 10, 'collisions': 14}, {'tx': 25, 'success': 10, 'collisions': 15}, {'tx': 11, 'success': 2, 'collisions': 9}, {'tx': 21, 'success': 12, 'collisions': 9}, {'tx': 20, 'success': 8, 'collisions': 12}, {'tx': 5, 'success': 0, 'collisions': 5}, {'tx': 14, 'success': 4, 'collisions': 10}, {'tx': 11, 'success': 2, 'collisions': 9}]"
46,20,47,307,136,171,0.5570032573289903,0.44299674267100975,0.6392,"[{'tx': 13, 'success': 5, 'collisions': 8}, {'tx': 21, 'success': 10, 'collisions': 11}, {'tx': 14, 'success': 6, 'collisions': 8}, {'tx': 20, 'success': 11, 'collisions': 9}, {'tx': 20, 'success': 9, 'collisions': 11}, {'tx': 9, 'success': 2, 'collisions': 7}, {'tx': 18, 'success': 8, 'collisions': 10}, {'tx': 5, 'success': 0, 'collisions': 5}, {'tx': 17, 'success': 7, 'collisions': 10}, {'tx': 8, 'success': 1, 'collisions': 7}, {'tx': 12, 'success': 3, 'collisions': 9}, {'tx': 5, 'success': 1, 'collisions': 4}, {'tx': 33, 'success': 22, 'collisions': 11}, {'tx': 8, 'success': 2, 'collisions': 6}, {'tx': 26, 'success': 15, 'collisions': 11}, {'tx': 8, 'success': 2, 'collisions': 6}, {'tx': 15, 'success': 8, 'collisions': 7}, {'tx': 20, 'success': 10, 'collisions': 10}, {'tx': 16, 'success': 7, 'collisions': 9}, {'tx': 19, 'success': 7, 'collisions': 12}]"
47,20,48,304,134,170,0.5592105263157895,0.4407894736842105,0.6432,"[{'tx': 7, 'success': 1, 'collisions': 6}, {'tx': 31, 'success': 15, 'collisions': 16}, {'tx': 8, 'success': 1, 'collisions': 7}, {'tx': 9, 'success': 3, 'collisions': 6}, {'tx': 17, 'success': 6, 'collisions': 11}, {'tx': 31, 'success': 16, 'collisions': 15}, {'tx': 15, 'success': 6, 'collisions': 9}, {'tx': 20, 'success': 10, 'collisions': 10}, {'tx': 4, 'success': 0, 'collisions': 4}, {'tx': 14, 'success': 7, 'collisions': 7}, {'tx': 29, 'success': 17, 'collisions': 12}, {'tx': 11, 'success': 5, 'collisions': 6}, {'tx': 8, 'success': 2, 'collisions': 6}, {'tx': 21, 'success': 9, 'collisions': 12}, {'tx': 6, 'success': 1, 'collisions': 5}, {'tx': 21, 'success': 12, 'collisions': 9}, {'tx': 8, 'success': 1, 'collisions': 7}, {'tx': 16, 'success': 8, 'collisions': 8}, {'tx': 5, 'success': 1, 'collisions': 4}, {'tx': 23, 'success': 13, 'collisions': 10}]"
48,20,49,305,130,175,0.5737704918032787,0.4262295081967213,0.637,"[{'tx': 13, 'success': 3, 'collisions': 10}, {'tx': 19, 'success': 9, 'collisions': 10}, {'tx': 5, 'success': 0, 'collisions': 5}, {'tx': 18, 'success': 10, 'collisions': 8}, {'tx': 9, 'success': 2, 'collisions': 7}, {'tx': 13, 'success': 5, 'collisions': 8}, {'tx': 11, 'success': 4, 'collisions': 7}, {'tx': 15, 'success': 4, 'collisions': 11}, {'tx': 15, 'success': 5, 'collisions': 10}, {'tx': 16, 'success': 7, 'collisions': 9}, {'tx': 15, 'success': 6, 'collisions': 9}, {'tx': 15, 'success': 5, 'collisions': 10}, {'tx': 10, 'success': 3, 'collisions': 7}, {'tx': 24, 'success': 13, 'collisions': 11}, {'tx': 24, 'success': 16, 'collisions': 8}, {'tx': 22, 'success': 12, 'collisions': 10}, {'tx': 16, 'success': 5, 'collisions': 11}, {'tx': 19, 'success': 11, 'collisions': 8}, {'tx': 19, 'success': 9, 'collisions': 10}, {'tx': 7, 'success': 1, 'collisions': 6}]"
49,20,50,294,123,171,0.5816326530612245,0.41836734693877553,0.615,"[{'tx': 13, 'success': 5, 'collisions': 8}, {'tx': 26, 'success': 17, 'collisions': 9}, {'tx': 17, 'success': 7, 'collisions': 10}, {'tx': 23, 'success': 13, 'collisions': 10}, {'tx': 8, 'success': 2, 'collisions': 6}, {'tx': 5, 'success': 1, 'collisions': 4}, {'tx': 18, 'success': 6, 'collisions': 12}, {'tx': 13, 'success': 5, 'collisions': 8}, {'tx': 12, 'success': 6, 'collisions': 6}, {'tx': 14, 'success': 5, 'collisions': 9}, {'tx': 10, 'success': 3, 'collisions': 7}, {'tx': 17, 'success': 7, 'collisions': 10}, {'tx': 23, 'success': 11, 'collisions': 12}, {'tx': 14, 'success': 4, 'collisions': 10}, {'tx': 12, 'success': 3, 'collisions': 9}, {'tx': 8, 'success': 2, 'collisions': 6}, {'tx': 19, 'success': 10, 'collisions': 9}, {'tx': 16, 'success': 8, 'collisions': 8}, {'tx': 9, 'success': 1, 'collisions': 8}, {'tx': 17, 'success': 7, 'collisions': 10}]"
50,20,51,294,115,179,0.608843537414966,0.391156462585034,0.5865,"[{'tx': 15, 'success': 6, 'collisions': 9}, {'tx': 10, 'success': 2, 'collisions': 8}, {'tx': 18, 'success': 6, 'collisions': 12}, {'tx': 12, 'success': 5, 'collisions': 7}, {'tx': 21, 'success': 12, 'collisions': 9}, {'tx': 11, 'success': 3, 'collisions': 8}, {'tx': 11, 'success': 2, 'collisions': 9}, {'tx': 5, 'success': 0, 'collisions': 5}, {'tx': 23, 'success': 12, 'collisions': 11}, {'tx': 11, 'success': 4, 'collisions': 7}, {'tx': 11, 'success': 3, 'collisions': 8}, {'tx': 19, 'success': 10, 'collisions': 9}, {'tx': 27, 'success': 16, 'collisions': 11}, {'tx': 10, 'success': 2, 'collisions': 8}, {'tx': 13, 'success': 4, 'collisions': 9}, {'tx': 10, 'success': 2, 'collisions': 8}, {'tx': 6, 'success': 1, 'collisions': 5}, {'tx': 16, 'success': 6, 'collisions': 10}, {'tx': 23, 'success': 9, 'collisions': 14}, {'tx': 22, 'success': 10, 'collisions': 12}]"
51,20,52,280,119,161,0.575,0.425,0.6188,"[{'tx': 8, 'success': 1, 'collisions': 7}, {'tx': 12, 'success': 2, 'collisions': 10}, {'tx': 10, 'success': 3, 'collisions': 7}, {'tx': 13, 'success': 4, 'collisions': 9}, {'tx': 6, 'success': 1, 'collisions': 5}, {'tx': 5, 'success': 0, 'collisions': 5}, {'tx': 15, 'success': 6, 'collisions': 9}, {'tx': 22, 'success': 11, 'collisions': 11}, {'tx': 28, 'success': 20, 'collisions': 8}, {'tx': 21, 'success': 13, 'collisions': 8}, {'tx': 17, 'success': 7, 'collisions': 10}, {'tx': 5, 'success': 0, 'collisions': 5}, {'tx': 11, 'success': 3, 'collisions': 8}, {'tx': 8, 'success': 3, 'collisions': 5}, {'tx': 9, 'success': 1, 'collisions': 8}, {'tx': 4, 'success': 0, 'collisions': 4}, {'tx': 21, 'success': 10, 'collisions': 11}, {'tx': 25, 'success': 14, 'collisions': 11}, {'tx': 24, 'success': 14, 'collisions': 10}, {'tx': 16, 'success': 6, 'collisions': 10}]"
52,20,53,288,116,172,0.5972222222222222,0.4027777777777778,0.6148,"[{'tx': 5, 'success': 0, 'collisions': 5}, {'tx': 5, 'success': 0, 'collisions': 5}, {'tx': 22, 'success': 11, 'collisions': 11}, {'tx': 14, 'success': 6, 'collisions': 8}, {'tx': 15, 'success': 6, 'collisions': 9}, {'tx': 21, 'success': 10, 'collisions': 11}, {'tx': 19, 'success': 11, 'collisions': 8}, {'tx': 19, 'success': 11, 'collisions': 8}, {'tx': 18, 'success': 8, 'collisions': 10}, {'tx': 5, 'success': 0, 'collisions': 5}, {'tx': 21, 'success': 9, 'collisions': 12}, {'tx': 12, 'success': 4, 'collisions': 8}, {'tx': 20, 'success': 9, 'collisions': 11}, {'tx': 7, 'success': 2, 'collisions': 5}, {'tx': 17, 'success': 7, 'collisions': 10}, {'tx': 17, 'success': 5, 'collisions': 12}, {'tx': 5, 'success': 0, 'collisions': 5}, {'tx': 19, 'success': 8, 'collisions': 11}, {'tx': 12, 'success': 4, 'collisions': 8}, {'tx': 15, 'success': 5, 'collisions': 10}]"
53,20,54,270,119,151,0.5592592592592592,0.44074074074074077,0.6426,"[{'tx': 17, 'success': 7, 'collisions': 10}, {'tx': 16, 'success': 8, 'collisions': 8}, {'tx': 9, 'success': 2, 'collisions': 7}, {'tx': 18, 'success': 10, 'collisions': 8}, {'tx': 13, 'success': 6, 'collisions': 7}, {'tx': 9, 'success': 2, 'collisions': 7}, {'tx': 9, 'success': 2, 'collisions': 7}, {'tx': 13, 'success': 6, 'collisions': 7}, {'tx': 9, 'success': 3, 'collisions': 6}, {'tx': 26, 'success': 13, 'collisions': 13}, {'tx': 15, 'success': 6, 'collisions': 9}, {'tx': 4, 'success': 0, 'collisions': 4}, {'tx': 8, 'success': 1, 'collisions': 7}, {'tx': 8, 'success': 2, 'collisions': 6}, {'tx': 15, 'success': 7, 'collisions': 8}, {'tx': 22, 'success': 14, 'collisions': 8}, {'tx': 9, 'success': 3, 'collisions': 6}, {'tx': 23, 'success': 16, 'collisions': 7}, {'tx': 10, 'success': 2, 'collisions': 8}, {'tx': 17, 'success': 9, 'collisions': 8}]"
54,20,55,272,111,161,0.5919117647058824,0.40808823529411764,0.6105,"[{'tx': 17, 'success': 7, 'collisions': 10}, {'tx': 4, 'success': 0, 'collisions': 4}, {'tx': 13, 'success': 5, 'collisions': 8}, {'tx': 17, 'success': 9, 'collisions': 8}, {'tx': 7, 'success': 1, 'collisions': 6}, {'tx': 17, 'success': 6, 'collisions': 11}, {'tx': 27, 'success': 18, 'collisions': 9}, {'tx': 19, 'success': 11, 'collisions': 8}, {'tx': 11, 'success': 4, 'collisions': 7}, {'tx': 12, 'success': 3, 'collisions': 9}, {'tx': 5, 'success': 0, 'collisions': 5}, {'tx': 15, 'success': 5, 'collisions': 10}, {'tx': 22, 'success': 11, 'collisions': 11}, {'tx': 20, 'success': 11, 'collisions': 9}, {'tx': 12, 'success': 4, 'collisions': 8}, {'tx': 8, 'success': 1, 'collisions': 7}, {'tx': 14, 'success': 5, 'collisions': 9}, {'tx': 16, 'success': 5, 'collisions': 11}, {'tx': 10, 'success': 4, 'collisions': 6}, {'tx': 6, 'success': 1, 'collisions': 5}]"
55,20,56,267,109,158,0.5917602996254682,0.40823970037453183,0.6104,"[{'tx': 15, 'success': 6, 'collisions': 9}, {'tx': 12, 'success': 4, 'collisions': 8}, {'tx': 17, 'success': 8, 'collisions': 9}, {'tx': 10, 'success': 3, 'collisions': 7}, {'tx': 12, 'success': 4, 'collisions': 8}, {'tx': 16, 'success': 6, 'collisions': 10}, {'tx': 18, 'success': 11, 'collisions': 7}, {'tx': 12, 'success': 5, 'collisions': 7}, {'tx': 17, 'success': 6, 'collisions': 11}, {'tx': 20, 'success': 10, 'collisions': 10}, {'tx': 12, 'success': 6, 'collisions': 6}, {'tx': 24, 'success': 13, 'collisions': 11}, {'tx': 18, 'success': 8, 'collisions': 10}, {'tx': 8, 'success': 2, 'collisions': 6}, {'tx': 13, 'success': 5, 'collisions': 8}, {'tx': 20, 'success': 10, 'collisions': 10}, {'tx': 4, 'success': 0, 'collisions': 4}, {'tx': 4, 'success': 0, 'collisions': 4}, {'tx': 5, 'success': 0, 'collisions': 5}, {'tx': 10, 'success': 2, 'collisions': 8}]"
56,20,57,257,111,146,0.5680933852140078,0.43190661478599224,0.6327,"[{'tx': 15, 'success': 7, 'collisions': 8}, {'tx': 20, 'success': 12, 'collisions': 8}, {'tx': 22, 'success': 12, 'collisions': 10}, {'tx': 23, 'success': 13, 'collisions': 10}, {'tx': 10, 'success': 3, 'collisions': 7}, {'tx': 20, 'success': 9, 'collisions': 11}, {'tx': 5, 'success': 0, 'collisions': 5}, {'tx': 5, 'success': 1, 'collisions': 4}, {'tx': 20, 'success': 12, 'collisions': 8}, {'tx': 10, 'success': 5, 'collisions': 5}, {'tx': 7, 'success': 1, 'collisions': 6}, {'tx': 17, 'success': 7, 'collisions': 10}, {'tx': 10, 'success': 2, 'collisions': 8}, {'tx': 10, 'success': 3, 'collisions': 7}, {'tx': 7, 'success': 1, 'collisions': 6}, {'tx': 10, 'success': 3, 'collisions': 7}, {'tx': 15, 'success': 9, 'collisions': 6}, {'tx': 14, 'success': 7, 'collisions': 7}, {'tx': 4, 'success': 0, 'collisions': 4}, {'tx': 13, 'success': 4, 'collisions': 9}]"
57,20,58,257,107,150,0.5836575875486382,0.4163424124513619,0.6206,"[{'tx': 5, 'success': 1, 'collisions': 4}, {'tx': 17, 'success': 8, 'collisions': 9}, {'tx': 4, 'success': 0, 'collisions': 4}, {'tx': 12, 'success': 6, 'collisions': 6}, {'tx': 17, 'success': 7, 'collisions': 10}, {'tx': 14, 'success': 6, 'collisions': 8}, {'tx': 19, 'success': 9, 'collisions': 10}, {'tx': 22, 'success': 10, 'collisions': 12}, {'tx': 7, 'success': 1, 'collisions': 6}, {'tx': 9, 'success': 4, 'collisions': 5}, {'tx': 18, 'success': 9, 'collisions': 9}, {'tx': 7, 'success': 2, 'collisions': 5}, {'tx': 18, 'success': 10, 'collisions': 8}, {'tx': 15, 'success': 8, 'collisions': 7}, {'tx': 14, 'success': 4, 'collisions': 10}, {'tx': 17, 'success': 8, 'collisions': 9}, {'tx': 11, 'success': 4, 'collisions': 7}, {'tx': 4, 'success': 0, 'collisions': 4}, {'tx': 10, 'success': 3, 'collisions': 7}, {'tx': 17, 'success': 7, 'collisions': 10}]"
58,20,59,250,101,149,0.596,0.404,0.5959,"[{'tx': 6, 'success': 1, 'collisions': 5}, {'tx': 20, 'success': 9, 'collisions': 11}, {'tx': 9, 'success': 3, 'collisions': 6}, {'tx': 10, 'success': 3, 'collisions': 7}, {'tx': 4, 'success': 0, 'collisions': 4}, {'tx': 5, 'success': 0, 'collisions': 5}, {'tx': 10, 'success': 2, 'collisions': 8}, {'tx': 19, 'success': 9, 'collisions': 10}, {'tx': 15, 'success': 7, 'collisions': 8}, {'tx': 15, 'success': 6, 'collisions': 9}, {'tx': 14, 'success': 7, 'collisions': 7}, {'tx': 15, 'success': 5, 'collisions': 10}, {'tx': 13, 'success': 6, 'collisions': 7}, {'tx': 4, 'success': 0, 'collisions': 4}, {'tx': 23, 'success': 13, 'collisions': 10}, {'tx': 18, 'success': 8, 'collisions': 10}, {'tx': 10, 'success': 3, 'collisions': 7}, {'tx': 11, 'success': 3, 'collisions': 8}, {'tx': 17, 'success': 10, 'collisions': 7}, {'tx': 12, 'success': 6, 'collisions': 6}]"
59,20,60,252,100,152,0.6031746031746031,0.3968253968253968,0.6,"[{'tx': 12, 'success': 5, 'collisions': 7}, {'tx': 18, 'success': 10, 'collisions': 8}, {'tx': 13, 'success': 3, 'collisions': 10}, {'tx': 12, 'success': 4, 'collisions': 8}, {'tx': 4, 'success': 0, 'collisions': 4}, {'tx': 18, 'success': 7, 'collisions': 11}, {'tx': 5, 'success': 1, 'collisions': 4}, {'tx': 25, 'success': 13, 'collisions': 12}, {'tx': 6, 'success': 0, 'collisions': 6}, {'tx': 17, 'success': 8, 'collisions': 9}, {'tx': 11, 'success': 3, 'collisions': 8}, {'tx': 11, 'success': 4, 'collisions': 7}, {'tx': 6, 'success': 1, 'collisions': 5}, {'tx': 7, 'success': 1, 'collisions': 6}, {'tx': 10, 'success': 3, 'collisions': 7}, {'tx': 23, 'success': 14, 'collisions': 9}, {'tx': 4, 'success': 0, 'collisions': 4}, {'tx': 20, 'success': 9, 'collisions': 11}, {'tx': 17, 'success': 9, 'collisions': 8}, {'tx': 13, 'success': 5, 'collisions': 8}]"
60,20,61,243,101,142,0.5843621399176955,0.4156378600823045,0.6161,"[{'tx': 12, 'success': 5, 'collisions': 7}, {'tx': 19, 'success': 9, 'collisions': 10}, {'tx': 19, 'success': 10, 'collisions': 9}, {'tx': 13, 'success': 6, 'collisions': 7}, {'tx': 6, 'success': 0, 'collisions': 6}, {'tx': 17, 'success': 11, 'collisions': 6}, {'tx': 16, 'success': 9, 'collisions': 7}, {'tx': 7, 'success': 1, 'collisions': 6}, {'tx': 5, 'success': 0, 'collisions': 5}, {'tx': 17, 'success': 10, 'collisions': 7}, {'tx': 13, 'success': 4, 'collisions': 9}, {'tx': 8, 'success': 2, 'collisions': 6}, {'tx': 7, 'success': 1, 'collisions': 6}, {'tx': 15, 'success': 5, 'collisions': 10}, {'tx': 4, 'success': 0, 'collisions': 4}, {'tx': 19, 'success': 10, 'collisions': 9}, {'tx': 15, 'success': 8, 'collisions': 7}, {'tx': 14, 'success': 6, 'collisions': 8}, {'tx': 13, 'success': 4, 'collisions': 9}, {'tx': 4, 'success': 0, 'collisions': 4}]"
61,20,62,236,103,133,0.5635593220338984,0.4364406779661017,0.6386,"[{'tx': 5, 'success': 1, 'collisions': 4}, {'tx': 8, 'success': 2, 'collisions': 6}, {'tx': 4, 'success': 0, 'collisions': 4}, {'tx': 18, 'success': 10, 'collisions': 8}, {'tx': 14, 'success': 6, 'collisions': 8}, {'tx': 4, 'success': 0, 'collisions': 4}, {'tx': 20, 'success': 13, 'collisions': 7}, {'tx': 13, 'success': 5, 'collisions': 8}, {'tx': 4, 'success': 0, 'collisions': 4}, {'tx': 15, 'success': 6, 'collisions': 9}, {'tx': 5, 'success': 0, 'collisions': 5}, {'tx': 12, 'success': 4, 'collisions': 8}, {'tx': 15, 'success': 8, 'collisions': 7}, {'tx': 11, 'success': 3, 'collisions': 8}, {'tx': 11, 'success': 3, 'collisions': 8}, {'tx': 17, 'success': 11, 'collisions': 6}, {'tx': 4, 'success': 0, 'collisions': 4}, {'tx': 23, 'success': 13, 'collisions': 10}, {'tx': 9, 'success': 3, 'collisions': 6}, {'tx': 24, 'success': 15, 'collisions': 9}]"
62,20,63,248,88,160,0.6451612903225806,0.3548387096774194,0.5544,"[{'tx': 18, 'success': 6, 'collisions': 12}, {'tx': 4, 'success': 0, 'collisions': 4}, {'tx': 16, 'success': 6, 'collisions': 10}, {'tx': 27, 'success': 14, 'collisions': 13}, {'tx': 8, 'success': 1, 'collisions': 7}, {'tx': 8, 'success': 2, 'collisions': 6}, {'tx': 18, 'success': 8, 'collisions': 10}, {'tx': 16, 'success': 5, 'collisions': 11}, {'tx': 14, 'success': 7, 'collisions': 7}, {'tx': 21, 'success': 8, 'collisions': 13}, {'tx': 15, 'success': 6, 'collisions': 9}, {'tx': 7, 'success': 1, 'collisions': 6}, {'tx': 17, 'success': 7, 'collisions': 10}, {'tx': 4, 'success': 0, 'collisions': 4}, {'tx': 10, 'success': 2, 'collisions': 8}, {'tx': 5, 'success': 0, 'collisions': 5}, {'tx': 4, 'success': 0, 'collisions': 4}, {'tx': 15, 'success': 8, 'collisions': 7}, {'tx': 5, 'success': 0, 'collisions': 5}, {'tx': 16, 'success': 7, 'collisions': 9}]"
63,20,64,232,90,142,0.6120689655172413,0.3879310344827586,0.576,"[{'tx': 13, 'success': 5, 'collisions': 8}, {'tx': 13, 'success': 4, 'collisions': 9}, {'tx': 4, 'success': 0, 'collisions': 4}, {'tx': 11, 'success': 5, 'collisions': 6}, {'tx': 6, 'success': 0, 'collisions': 6}, {'tx': 8, 'success': 2, 'collisions': 6}, {'tx': 20, 'success': 12, 'collisions': 8}, {'tx': 17, 'success': 8, 'collisions': 9}, {'tx': 12, 'success': 5, 'collisions': 7}, {'tx': 11, 'success': 4, 'collisions': 7}, {'tx': 15, 'success': 8, 'collisions': 7}, {'tx': 17, 'success': 8, 'collisions': 9}, {'tx': 10, 'success': 3, 'collisions': 7}, {'tx': 9, 'success': 2, 'collisions': 7}, {'tx': 18, 'success': 10, 'collisions': 8}, {'tx': 10, 'success': 3, 'collisions': 7}, {'tx': 6, 'success': 1, 'collisions': 5}, {'tx': 9, 'success': 3, 'collisions': 6}, {'tx': 11, 'success': 4, 'collisions': 7}, {'tx': 12, 'success': 3, 'collisions': 9}]"
64,20,65,227,95,132,0.5814977973568282,0.4185022026431718,0.6175,"[{'tx': 8, 'success': 2, 'collisions': 6}, {'tx': 15, 'success': 8, 'collisions': 7}, {'tx': 5, 'success': 0, 'collisions': 5}, {'tx': 11, 'success': 4, 'collisions': 7}, {'tx': 13, 'success': 5, 'collisions': 8}, {'tx': 12, 'success': 4, 'collisions': 8}, {'tx': 14, 'success': 8, 'collisions': 6}, {'tx': 22, 'success': 12, 'collisions': 10}, {'tx': 9, 'success': 3, 'collisions': 6}, {'tx': 8, 'success': 1, 'collisions': 7}, {'tx': 13, 'success': 5, 'collisions': 8}, {'tx': 8, 'success': 3, 'collisions': 5}, {'tx': 4, 'success': 0, 'collisions': 4}, {'tx': 7, 'success': 1, 'collisions': 6}, {'tx': 23, 'success': 14, 'collisions': 9}, {'tx': 4, 'success': 0, 'collisions': 4}, {'tx': 14, 'success': 8, 'collisions': 6}, {'tx': 13, 'success': 4, 'collisions': 9}, {'tx': 20, 'success': 13, 'collisions': 7}, {'tx': 4, 'success': 0, 'collisions': 4}]"
65,20,66,226,91,135,0.5973451327433629,0.4026548672566372,0.6006,"[{'tx': 11, 'success': 4, 'collisions': 7}, {'tx': 13, 'success': 6, 'collisions': 7}, {'tx': 13, 'success': 6, 'collisions': 7}, {'tx': 13, 'success': 6, 'collisions': 7}, {'tx': 11, 'success': 4, 'collisions': 7}, {'tx': 10, 'success': 5, 'collisions': 5}, {'tx': 10, 'success': 2, 'collisions': 8}, {'tx': 16, 'success': 10, 'collisions': 6}, {'tx': 7, 'success': 2, 'collisions': 5}, {'tx': 14, 'success': 7, 'collisions': 7}, {'tx': 8, 'success': 3, 'collisions': 5}, {'tx': 14, 'success': 7, 'collisions': 7}, {'tx': 17, 'success': 7, 'collisions': 10}, {'tx': 12, 'success': 4, 'collisions': 8}, {'tx': 12, 'success': 4, 'collisions': 8}, {'tx': 10, 'success': 4, 'collisions': 6}, {'tx': 7, 'success': 1, 'collisions': 6}, {'tx': 11, 'success': 5, 'collisions': 6}, {'tx': 12, 'success': 4, 'collisions': 8}, {'tx': 5, 'success': 0, 'collisions': 5}]"
66,20,67,226,88,138,0.6106194690265486,0.3893805309734513,0.5896,"[{'tx': 18, 'success': 9, 'collisions': 9}, {'tx': 18, 'success': 11, 'collisions': 7}, {'tx': 12, 'success': 5, 'collisions': 7}, {'tx': 15, 'success': 7, 'collisions': 8}, {'tx': 14, 'success': 7, 'collisions': 7}, {'tx': 14, 'success': 6, 'collisions': 8}, {'tx': 8, 'success': 1, 'collisions': 7}, {'tx': 11, 'success': 3, 'collisions': 8}, {'tx': 13, 'success': 6, 'collisions': 7}, {'tx': 7, 'success': 1, 'collisions': 6}, {'tx': 14, 'success': 7, 'collisions': 7}, {'tx': 6, 'success': 1, 'collisions': 5}, {'tx': 14, 'success': 7, 'collisions': 7}, {'tx': 11, 'success': 4, 'collisions': 7}, {'tx': 15, 'success': 5, 'collisions': 10}, {'tx': 10, 'success': 4, 'collisions': 6}, {'tx': 5, 'success': 0, 'collisions': 5}, {'tx': 12, 'success': 3, 'collisions': 9}, {'tx': 4, 'success': 0, 'collisions': 4}, {'tx': 5, 'success': 1, 'collisions': 4}]"
67,20,68,221,87,134,0.6063348416289592,0.3936651583710407,0.5916,"[{'tx': 10, 'success': 3, 'collisions': 7}, {'tx': 20, 'success': 11, 'collisions': 9}, {'tx': 4, 'success': 0, 'collisions': 4}, {'tx': 4, 'success': 0, 'collisions': 4}, {'tx': 9, 'success': 2, 'collisions': 7}, {'tx': 13, 'success': 3, 'collisions': 10}, {'tx': 6, 'success': 1, 'collisions': 5}, {'tx': 16, 'success': 9, 'collisions': 7}, {'tx': 12, 'success': 5, 'collisions': 7}, {'tx': 8, 'success': 1, 'collisions': 7}, {'tx': 9, 'success': 2, 'collisions': 7}, {'tx': 16, 'success': 8, 'collisions': 8}, {'tx': 10, 'success': 3, 'collisions': 7}, {'tx': 4, 'success': 0, 'collisions': 4}, {'tx': 13, 'success': 7, 'collisions': 6}, {'tx': 16, 'success': 8, 'collisions': 8}, {'tx': 12, 'success': 5, 'collisions': 7}, {'tx': 16, 'success': 7, 'collisions': 9}, {'tx': 8, 'success': 2, 'collisions': 6}, {'tx': 15, 'success': 10, 'collisions': 5}]"
68,20,69,212,90,122,0.5754716981132075,0.42452830188679247,0.621,"[{'tx': 11, 'success': 4, 'collisions': 7}, {'tx': 18, 'success': 10, 'collisions': 8}, {'tx': 11, 'success': 5, 'collisions': 6}, {'tx': 19, 'success': 10, 'collisions': 9}, {'tx': 5, 'success': 0, 'collisions': 5}, {'tx': 10, 'success': 5, 'collisions': 5}, {'tx': 7, 'success': 3, 'collisions': 4}, {'tx': 5, 'success': 1, 'collisions': 4}, {'tx': 11, 'success': 3, 'collisions': 8}, {'tx': 7, 'success': 3, 'collisions': 4}, {'tx': 3, 'success': 0, 'collisions': 3}, {'tx': 6, 'success': 1, 'collisions': 5}, {'tx': 18, 'success': 12, 'collisions': 6}, {'tx': 11, 'success': 5, 'collisions': 6}, {'tx': 17, 'success': 8, 'collisions': 9}, {'tx': 13, 'success': 5, 'collisions': 8}, {'tx': 6, 'success': 1, 'collisions': 5}, {'tx': 14, 'success': 6, 'collisions': 8}, {'tx': 5, 'success': 1, 'collisions': 4}, {'tx': 15, 'success': 7, 'collisions': 8}]"
69,20,70,218,88,130,0.5963302752293578,0.4036697247706422,0.616,"[{'tx': 7, 'success': 2, 'collisions': 5}, {'tx': 11, 'success': 5, 'collisions': 6}, {'tx': 7, 'success': 2, 'collisions': 5}, {'tx': 17, 'success': 8, 'collisions': 9}, {'tx': 9, 'success': 3, 'collisions': 6}, {'tx': 10, 'success': 3, 'collisions': 7}, {'tx': 9, 'success': 3, 'collisions': 6}, {'tx': 12, 'success': 4, 'collisions': 8}, {'tx': 24, 'success': 16, 'collisions': 8}, {'tx': 4, 'success': 0, 'collisions': 4}, {'tx': 12, 'success': 4, 'collisions': 8}, {'tx': 11, 'success': 4, 'collisions': 7}, {'tx': 13, 'success': 6, 'collisions': 7}, {'tx': 4, 'success': 0, 'collisions': 4}, {'tx': 8, 'success': 2, 'collisions': 6}, {'tx': 10, 'success': 2, 'collisions': 8}, {'tx': 18, 'success': 12, 'collisions': 6}, {'tx': 12, 'success': 6, 'collisions': 6}, {'tx': 14, 'success': 6, 'collisions': 8}, {'tx': 6, 'success': 0, 'collisions': 6}]"
70,20,71,217,89,128,0.5898617511520737,0.41013824884792627,0.6319,"[{'tx': 17, 'success': 11, 'collisions': 6}, {'tx': 4, 'success': 0, 'collisions': 4}, {'tx': 6, 'success': 1, 'collisions': 5}, {'tx': 9, 'success': 2, 'collisions': 7}, {'tx': 15, 'success': 6, 'collisions': 9}, {'tx': 5, 'success': 1, 'collisions': 4}, {'tx': 5, 'success': 0, 'collisions': 5}, {'tx': 14, 'success': 6, 'collisions': 8}, {'tx': 12, 'success': 5, 'collisions': 7}, {'tx': 19, 'success': 10, 'collisions': 9}, {'tx': 17, 'success': 9, 'collisions': 8}, {'tx': 15, 'success': 7, 'collisions': 8}, {'tx': 6, 'success': 1, 'collisions': 5}, {'tx': 5, 'success': 0, 'collisions': 5}, {'tx': 5, 'success': 1, 'collisions': 4}, {'tx': 15, 'success': 7, 'collisions': 8}, {'tx': 10, 'success': 4, 'collisions': 6}, {'tx': 6, 'success': 1, 'collisions': 5}, {'tx': 15, 'success': 8, 'collisions': 7}, {'tx': 17, 'success': 9, 'collisions': 8}]"
71,20,72,203,88,115,0.5665024630541872,0.43349753694581283,0.6336,"[{'tx': 8, 'success': 3, 'collisions': 5}, {'tx': 4, 'success': 0, 'collisions': 4}, {'tx': 9, 'success': 3, 'collisions': 6}, {'tx': 5, 'success': 0, 'collisions': 5}, {'tx': 6, 'success': 1, 'collisions': 5}, {'tx': 14, 'success': 7, 'collisions': 7}, {'tx': 12, 'success': 5, 'collisions': 7}, {'tx': 5, 'success': 1, 'collisions': 4}, {'tx': 18, 'success': 7, 'collisions': 11}, {'tx': 10, 'success': 4, 'collisions': 6}, {'tx': 8, 'success': 3, 'collisions': 5}, {'tx': 7, 'success': 3, 'collisions': 4}, {'tx': 9, 'success': 4, 'collisions': 5}, {'tx': 17, 'success': 13, 'collisions': 4}, {'tx': 12, 'success': 5, 'collisions': 7}, {'tx': 13, 'success': 8, 'collisions': 5}, {'tx': 9, 'success': 5, 'collisions': 4}, {'tx': 21, 'success': 11, 'collisions': 10}, {'tx': 12, 'success': 5, 'collisions': 7}, {'tx': 4, 'success': 0, 'collisions': 4}]"
72,20,73,213,77,136,0.6384976525821596,0.3615023474178404,0.5621,"[{'tx': 16, 'success': 8, 'collisions': 8}, {'tx': 5, 'success': 0, 'collisions': 5}, {'tx': 4, 'success': 0, 'collisions': 4}, {'tx': 6, 'success': 1, 'collisions': 5}, {'tx': 14, 'success': 6, 'collisions': 8}, {'tx': 14, 'success': 6, 'collisions': 8}, {'tx': 18, 'success': 8, 'collisions': 10}, {'tx': 4, 'success': 0, 'collisions': 4}, {'tx': 17, 'success': 8, 'collisions': 9}, {'tx': 18, 'success': 8, 'collisions': 10}, {'tx': 5, 'success': 0, 'collisions': 5}, {'tx': 4, 'success': 0, 'collisions': 4}, {'tx': 12, 'success': 4, 'collisions': 8}, {'tx': 14, 'success': 5, 'collisions': 9}, {'tx': 9, 'success': 2, 'collisions': 7}, {'tx': 8, 'success': 1, 'collisions': 7}, {'tx': 15, 'success': 7, 'collisions': 8}, {'tx': 5, 'success': 0, 'collisions': 5}, {'tx': 21, 'success': 13, 'collisions': 8}, {'tx': 4, 'success': 0, 'collisions': 4}]"
73,20,74,204,83,121,0.5931372549019608,0.4068627450980392,0.6142,"[{'tx': 20, 'success': 9, 'collisions': 11}, {'tx': 13, 'success': 6, 'collisions': 7}, {'tx': 7, 'success': 2, 'collisions': 5}, {'tx': 6, 'success': 1, 'collisions': 5}, {'tx': 10, 'success': 3, 'collisions': 7}, {'tx': 18, 'success': 8, 'collisions': 10}, {'tx': 12, 'success': 6, 'collisions': 6}, {'tx': 12, 'success': 6, 'collisions': 6}, {'tx': 12, 'success': 5, 'collisions': 7}, {'tx': 11, 'success': 5, 'collisions': 6}, {'tx': 10, 'success': 4, 'collisions': 6}, {'tx': 8, 'success': 2, 'collisions': 6}, {'tx': 8, 'success': 3, 'collisions': 5}, {'tx': 4, 'success': 0, 'collisions': 4}, {'tx': 11, 'success': 6, 'collisions': 5}, {'tx': 11, 'success': 6, 'collisions': 5}, {'tx': 5, 'success': 0, 'collisions': 5}, {'tx': 7, 'success': 3, 'collisions': 4}, {'tx': 5, 'success': 0, 'collisions': 5}, {'tx': 14, 'success': 8, 'collisions': 6}]"
74,20,75,207,80,127,0.6135265700483091,0.3864734299516908,0.6,"[{'tx': 11, 'success': 5, 'collisions': 6}, {'tx': 4, 'success': 0, 'collisions': 4}, {'tx': 7, 'success': 2, 'collisions': 5}, {'tx': 4, 'success': 0, 'collisions': 4}, {'tx': 13, 'success': 5, 'collisions': 8}, {'tx': 8, 'success': 3, 'collisions': 5}, {'tx': 14, 'success': 7, 'collisions': 7}, {'tx': 8, 'success': 1, 'collisions': 7}, {'tx': 19, 'success': 10, 'collisions': 9}, {'tx': 19, 'success': 10, 'collisions': 9}, {'tx': 20, 'success': 10, 'collisions': 10}, {'tx': 13, 'success': 5, 'collisions': 8}, {'tx': 7, 'success': 2, 'collisions': 5}, {'tx': 9, 'success': 4, 'collisions': 5}, {'tx': 15, 'success': 7, 'collisions': 8}, {'tx': 9, 'success': 3, 'collisions': 6}, {'tx': 11, 'success': 3, 'collisions': 8}, {'tx': 4, 'success': 0, 'collisions': 4}, {'tx': 8, 'success': 3, 'collisions': 5}, {'tx': 4, 'success': 0, 'collisions': 4}]"
75,20,76,206,76,130,0.6310679611650486,0.36893203883495146,0.5776,"[{'tx': 18, 'success': 8, 'collisions': 10}, {'tx': 10, 'success': 4, 'collisions': 6}, {'tx': 16, 'success': 8, 'collisions': 8}, {'tx': 7, 'success': 1, 'collisions': 6}, {'tx': 8, 'success': 2, 'collisions': 6}, {'tx': 4, 'success': 0, 'collisions': 4}, {'tx': 4, 'success': 0, 'collisions': 4}, {'tx': 14, 'success': 6, 'collisions': 8}, {'tx': 4, 'success': 0, 'collisions': 4}, {'tx': 7, 'success': 2, 'collisions': 5}, {'tx': 7, 'success': 2, 'collisions': 5}, {'tx': 16, 'success': 7, 'collisions': 9}, {'tx': 4, 'success': 0, 'collisions': 4}, {'tx': 11, 'success': 3, 'collisions': 8}, {'tx': 4, 'success': 0, 'collisions': 4}, {'tx': 14, 'success': 5, 'collisions': 9}, {'tx': 15, 'success': 7, 'collisions': 8}, {'tx': 14, 'success': 6, 'collisions': 8}, {'tx': 20, 'success': 12, 'collisions': 8}, {'tx': 9, 'success': 3, 'collisions': 6}]"
76,20,77,195,82,113,0.5794871794871795,0.4205128205128205,0.6314,"[{'tx': 4, 'success': 0, 'collisions': 4}, {'tx': 7, 'success': 2, 'collisions': 5}, {'tx': 6, 'success': 1, 'collisions': 5}, {'tx': 18, 'success': 10, 'collisions': 8}, {'tx': 6, 'success': 1, 'collisions': 5}, {'tx': 6, 'success': 2, 'collisions': 4}, {'tx': 11, 'success': 5, 'collisions': 6}, {'tx': 10, 'success': 3, 'collisions': 7}, {'tx': 15, 'success': 11, 'collisions': 4}, {'tx': 7, 'success': 3, 'collisions': 4}, {'tx': 14, 'success': 6, 'collisions': 8}, {'tx': 12, 'success': 5, 'collisions': 7}, {'tx': 9, 'success': 5, 'collisions': 4}, {'tx': 13, 'success': 5, 'collisions': 8}, {'tx': 11, 'success': 4, 'collisions': 7}, {'tx': 3, 'success': 0, 'collisions': 3}, {'tx': 17, 'success': 10, 'collisions': 7}, {'tx': 6, 'success': 1, 'collisions': 5}, {'tx': 5, 'success': 1, 'collisions': 4}, {'tx': 15, 'success': 7, 'collisions': 8}]"
77,20,78,202,77,125,0.6188118811881188,0.3811881188118812,0.6006,"[{'tx': 7, 'success': 2, 'collisions': 5}, {'tx': 7, 'success': 1, 'collisions': 6}, {'tx': 8, 'success': 3, 'collisions': 5}, {'tx': 11, 'success': 6, 'collisions': 5}, {'tx': 14, 'success': 6, 'collisions': 8}, {'tx': 11, 'success': 3, 'collisions': 8}, {'tx': 14, 'success': 5, 'collisions': 9}, {'tx': 14, 'success': 6, 'collisions': 8}, {'tx': 4, 'success': 0, 'collisions': 4}, {'tx': 5, 'success': 1, 'collisions': 4}, {'tx': 14, 'success': 8, 'collisions': 6}, {'tx': 10, 'success': 2, 'collisions': 8}, {'tx': 11, 'success': 5, 'collisions': 6}, {'tx': 12, 'success': 5, 'collisions': 7}, {'tx': 9, 'success': 5, 'collisions': 4}, {'tx': 17, 'success': 7, 'collisions': 10}, {'tx': 10, 'success': 4, 'collisions': 6}, {'tx': 4, 'success': 0, 'collisions': 4}, {'tx': 8, 'success': 3, 'collisions': 5}, {'tx': 12, 'success': 5, 'collisions': 7}]"
78,20,79,192,76,116,0.6041666666666666,0.3958333333333333,0.6004,"[{'tx': 5, 'success': 0, 'collisions': 5}, {'tx': 14, 'success': 6, 'collisions': 8}, {'tx': 19, 'success': 11, 'collisions': 8}, {'tx': 4, 'success': 0, 'collisions': 4}, {'tx': 4, 'success': 1, 'collisions': 3}, {'tx': 4, 'success': 0, 'collisions': 4}, {'tx': 21, 'success': 11, 'collisions': 10}, {'tx': 7, 'success': 2, 'collisions': 5}, {'tx': 4, 'success': 1, 'collisions': 3}, {'tx': 4, 'success': 0, 'collisions': 4}, {'tx': 11, 'success': 4, 'collisions': 7}, {'tx': 11, 'success': 4, 'collisions': 7}, {'tx': 13, 'success': 6, 'collisions': 7}, {'tx': 12, 'success': 4, 'collisions': 8}, {'tx': 15, 'success': 8, 'collisions': 7}, {'tx': 5, 'success': 1, 'collisions': 4}, {'tx': 4, 'success': 0, 'collisions': 4}, {'tx': 14, 'success': 8, 'collisions': 6}, {'tx': 17, 'success': 9, 'collisions': 8}, {'tx': 4, 'success': 0, 'collisions': 4}]"
79,20,80,191,75,116,0.6073298429319371,0.39267015706806285,0.6,"[{'tx': 10, 'success': 4, 'collisions': 6}, {'tx': 10, 'success': 3, 'collisions': 7}, {'tx': 10, 'success': 4, 'collisions': 6}, {'tx': 13, 'success': 7, 'collisions': 6}, {'tx': 13, 'success': 6, 'collisions': 7}, {'tx': 9, 'success': 3, 'collisions': 6}, {'tx': 14, 'success': 8, 'collisions': 6}, {'tx': 5, 'success': 0, 'collisions': 5}, {'tx': 13, 'success': 7, 'collisions': 6}, {'tx': 10, 'success': 5, 'collisions': 5}, {'tx': 11, 'success': 3, 'collisions': 8}, {'tx': 11, 'success': 4, 'collisions': 7}, {'tx': 4, 'success': 0, 'collisions': 4}, {'tx': 11, 'success': 6, 'collisions': 5}, {'tx': 4, 'success': 0, 'collisions': 4}, {'tx': 11, 'success': 5, 'collisions': 6}, {'tx': 14, 'success': 6, 'collisions': 8}, {'tx': 4, 'success': 0, 'collisions': 4}, {'tx': 4, 'success': 0, 'collisions': 4}, {'tx': 10, 'success': 4, 'collisions': 6}]"
80,20,81,194,73,121,0.6237113402061856,0.37628865979381443,0.5913,"[{'tx': 11, 'success': 5, 'collisions': 6}, {'tx': 17, 'success': 6, 'collisions': 11}, {'tx': 4, 'success': 1, 'collisions': 3}, {'tx': 10, 'success': 4, 'collisions': 6}, {'tx': 4, 'success': 0, 'collisions': 4}, {'tx': 4, 'success': 0, 'collisions': 4}, {'tx': 8, 'success': 3, 'collisions': 5}, {'tx': 18, 'success': 11, 'collisions': 7}, {'tx': 15, 'success': 8, 'collisions': 7}, {'tx': 13, 'success': 4, 'collisions': 9}, {'tx': 4, 'success': 0, 'collisions': 4}, {'tx': 10, 'success': 3, 'collisions': 7}, {'tx': 4, 'success': 0, 'collisions': 4}, {'tx': 18, 'success': 8, 'collisions': 10}, {'tx': 9, 'success': 5, 'collisions': 4}, {'tx': 6, 'success': 2, 'collisions': 4}, {'tx': 11, 'success': 3, 'collisions': 8}, {'tx': 8, 'success': 2, 'collisions': 6}, {'tx': 4, 'success': 0, 'collisions': 4}, {'tx': 16, 'success': 8, 'collisions': 8}]"
81,20,82,189,71,118,0.6243386243386243,0.37566137566137564,0.5822,"[{'tx': 18, 'success': 7, 'collisions': 11}, {'tx': 9, 'success': 3, 'collisions': 6}, {'tx': 8, 'success': 3, 'collisions': 5}, {'tx': 7, 'success': 2, 'collisions': 5}, {'tx': 10, 'success': 3, 'collisions': 7}, {'tx': 10, 'success': 3, 'collisions': 7}, {'tx': 10, 'success': 5, 'collisions': 5}, {'tx': 5, 'success': 0, 'collisions': 5}, {'tx': 7, 'success': 1, 'collisions': 6}, {'tx': 9, 'success': 2, 'collisions': 7}, {'tx': 14, 'success': 8, 'collisions': 6}, {'tx': 15, 'success': 9, 'collisions': 6}, {'tx': 11, 'success': 6, 'collisions': 5}, {'tx': 4, 'success': 0, 'collisions': 4}, {'tx': 11, 'success': 5, 'collisions': 6}, {'tx': 4, 'success': 0, 'collisions': 4}, {'tx': 6, 'success': 2, 'collisions': 4}, {'tx': 13, 'success': 7, 'collisions': 6}, {'tx': 8, 'success': 2, 'collisions': 6}, {'tx': 10, 'success': 3, 'collisions': 7}]"
82,20,83,183,76,107,0.5846994535519126,0.41530054644808745,0.6308,"[{'tx': 4, 'success': 0, 'collisions': 4}, {'tx': 8, 'success': 4, 'collisions': 4}, {'tx': 14, 'success': 8, 'collisions': 6}, {'tx': 7, 'success': 2, 'collisions': 5}, {'tx': 9, 'success': 3, 'collisions': 6}, {'tx': 13, 'success': 7, 'collisions': 6}, {'tx': 18, 'success': 11, 'collisions': 7}, {'tx': 8, 'success': 2, 'collisions': 6}, {'tx': 7, 'success': 2, 'collisions': 5}, {'tx': 4, 'success': 0, 'collisions': 4}, {'tx': 11, 'success': 6, 'collisions': 5}, {'tx': 15, 'success': 10, 'collisions': 5}, {'tx': 4, 'success': 0, 'collisions': 4}, {'tx': 12, 'success': 5, 'collisions': 7}, {'tx': 7, 'success': 2, 'collisions': 5}, {'tx': 9, 'success': 2, 'collisions': 7}, {'tx': 13, 'success': 8, 'collisions': 5}, {'tx': 5, 'success': 0, 'collisions': 5}, {'tx': 9, 'success': 3, 'collisions': 6}, {'tx': 6, 'success': 1, 'collisions': 5}]"
83,20,84,176,72,104,0.5909090909090909,0.4090909090909091,0.6048,"[{'tx': 7, 'success': 3, 'collisions': 4}, {'tx': 7, 'success': 2, 'collisions': 5}, {'tx': 11, 'success': 5, 'collisions': 6}, {'tx': 8, 'success': 3, 'collisions': 5}, {'tx': 12, 'success': 5, 'collisions': 7}, {'tx': 11, 'success': 6, 'collisions': 5}, {'tx': 6, 'success': 1, 'collisions': 5}, {'tx': 11, 'success': 4, 'collisions': 7}, {'tx': 13, 'success': 7, 'collisions': 6}, {'tx': 10, 'success': 5, 'collisions': 5}, {'tx': 12, 'success': 5, 'collisions': 7}, {'tx': 7, 'success': 3, 'collisions': 4}, {'tx': 3, 'success': 0, 'collisions': 3}, {'tx': 12, 'success': 7, 'collisions': 5}, {'tx': 9, 'success': 3, 'collisions': 6}, {'tx': 10, 'success': 5, 'collisions': 5}, {'tx': 10, 'success': 5, 'collisions': 5}, {'tx': 7, 'success': 1, 'collisions': 6}, {'tx': 4, 'success': 0, 'collisions': 4}, {'tx': 6, 'success': 2, 'collisions': 4}]"
84,20,85,183,66,117,0.639344262295082,0.36065573770491804,0.561,"[{'tx': 7, 'success': 1, 'collisions': 6}, {'tx': 7, 'success': 2, 'collisions': 5}, {'tx': 7, 'success': 1, 'collisions': 6}, {'tx': 11, 'success': 4, 'collisions': 7}, {'tx': 7, 'success': 3, 'collisions': 4}, {'tx': 12, 'success': 5, 'collisions': 7}, {'tx': 12, 'success': 6, 'collisions': 6}, {'tx': 18, 'success': 11, 'collisions': 7}, {'tx': 6, 'success': 1, 'collisions': 5}, {'tx': 12, 'success': 5, 'collisions': 7}, {'tx': 15, 'success': 7, 'collisions': 8}, {'tx': 6, 'success': 2, 'collisions': 4}, {'tx': 4, 'success': 0, 'collisions': 4}, {'tx': 6, 'success': 1, 'collisions': 5}, {'tx': 7, 'success': 1, 'collisions': 6}, {'tx': 6, 'success': 1, 'collisions': 5}, {'tx': 16, 'success': 8, 'collisions': 8}, {'tx': 5, 'success': 0, 'collisions': 5}, {'tx': 9, 'success': 3, 'collisions': 6}, {'tx': 10, 'success': 4, 'collisions': 6}]"
85,20,86,178,68,110,0.6179775280898876,0.38202247191011235,0.5848,"[{'tx': 6, 'success': 1, 'collisions': 5}, {'tx': 9, 'success': 3, 'collisions': 6}, {'tx': 11, 'success': 5, 'collisions': 6}, {'tx': 9, 'success': 3, 'collisions': 6}, {'tx': 4, 'success': 0, 'collisions': 4}, {'tx': 10, 'success': 4, 'collisions': 6}, {'tx': 6, 'success': 2, 'collisions': 4}, {'tx': 9, 'success': 3, 'collisions': 6}, {'tx': 5, 'success': 1, 'collisions': 4}, {'tx': 5, 'success': 0, 'collisions': 5}, {'tx': 10, 'success': 2, 'collisions': 8}, {'tx': 13, 'success': 7, 'collisions': 6}, {'tx': 9, 'success': 3, 'collisions': 6}, {'tx': 12, 'success': 7, 'collisions': 5}, {'tx': 8, 'success': 2, 'collisions': 6}, {'tx': 12, 'success': 7, 'collisions': 5}, {'tx': 9, 'success': 4, 'collisions': 5}, {'tx': 14, 'success': 6, 'collisions': 8}, {'tx': 4, 'success': 0, 'collisions': 4}, {'tx': 13, 'success': 8, 'collisions': 5}]"
86,20,87,177,69,108,0.6101694915254238,0.3898305084745763,0.6003,"[{'tx': 15, 'success': 9, 'collisions': 6}, {'tx': 7, 'success': 2, 'collisions': 5}, {'tx': 12, 'success': 6, 'collisions': 6}, {'tx': 13, 'success': 6, 'collisions': 7}, {'tx': 5, 'success': 0, 'collisions': 5}, {'tx': 9, 'success': 3, 'collisions': 6}, {'tx': 7, 'success': 1, 'collisions': 6}, {'tx': 8, 'success': 5, 'collisions': 3}, {'tx': 8, 'success': 3, 'collisions': 5}, {'tx': 12, 'success': 5, 'collisions': 7}, {'tx': 8, 'success': 2, 'collisions': 6}, {'tx': 4, 'success': 0, 'collisions': 4}, {'tx': 4, 'success': 0, 'collisions': 4}, {'tx': 6, 'success': 2, 'collisions': 4}, {'tx': 6, 'success': 1, 'collisions': 5}, {'tx': 4, 'success': 1, 'collisions': 3}, {'tx': 10, 'success': 6, 'collisions': 4}, {'tx': 7, 'success': 2, 'collisions': 5}, {'tx': 15, 'success': 7, 'collisions': 8}, {'tx': 17, 'success': 8, 'collisions': 9}]"
87,20,88,172,73,99,0.5755813953488372,0.42441860465116277,0.6424,"[{'tx': 12, 'success': 7, 'collisions': 5}, {'tx': 3, 'success': 0, 'collisions': 3}, {'tx': 6, 'success': 1, 'collisions': 5}, {'tx': 4, 'success': 0, 'collisions': 4}, {'tx': 8, 'success': 3, 'collisions': 5}, {'tx': 16, 'success': 8, 'collisions': 8}, {'tx': 6, 'success': 1, 'collisions': 5}, {'tx': 3, 'success': 0, 'collisions': 3}, {'tx': 8, 'success': 3, 'collisions': 5}, {'tx': 4, 'success': 0, 'collisions': 4}, {'tx': 15, 'success': 10, 'collisions': 5}, {'tx': 16, 'success': 12, 'collisions': 4}, {'tx': 12, 'success': 7, 'collisions': 5}, {'tx': 4, 'success': 0, 'collisions': 4}, {'tx': 5, 'success': 2, 'collisions': 3}, {'tx': 15, 'success': 7, 'collisions': 8}, {'tx': 7, 'success': 1, 'collisions': 6}, {'tx': 8, 'success': 3, 'collisions': 5}, {'tx': 11, 'success': 6, 'collisions': 5}, {'tx': 9, 'success': 2, 'collisions': 7}]"
88,20,89,172,71,101,0.5872093023255814,0.4127906976744186,0.6319,"[{'tx': 19, 'success': 11, 'collisions': 8}, {'tx': 9, 'success': 4, 'collisions': 5}, {'tx': 6, 'success': 2, 'collisions': 4}, {'tx': 4, 'success': 0, 'collisions': 4}, {'tx': 12, 'success': 8, 'collisions': 4}, {'tx': 9, 'success': 4, 'collisions': 5}, {'tx': 12, 'success': 6, 'collisions': 6}, {'tx': 7, 'success': 2, 'collisions': 5}, {'tx': 4, 'success': 0, 'collisions': 4}, {'tx': 12, 'success': 6, 'collisions': 6}, {'tx': 16, 'success': 9, 'collisions': 7}, {'tx': 8, 'success': 3, 'collisions': 5}, {'tx': 10, 'success': 3, 'collisions': 7}, {'tx': 6, 'success': 2, 'collisions': 4}, {'tx': 12, 'success': 5, 'collisions': 7}, {'tx': 4, 'success': 0, 'collisions': 4}, {'tx': 4, 'success': 0, 'collisions': 4}, {'tx': 8, 'success': 4, 'collisions': 4}, {'tx': 6, 'success': 2, 'collisions': 4}, {'tx': 4, 'success': 0, 'collisions': 4}]"
89,20,90,173,65,108,0.6242774566473989,0.37572254335260113,0.585,"[{'tx': 10, 'success': 4, 'collisions': 6}, {'tx': 15, 'success': 10, 'collisions': 5}, {'tx': 4, 'success': 0, 'collisions': 4}, {'tx': 13, 'success': 4, 'collisions': 9}, {'tx': 5, 'success': 0, 'collisions': 5}, {'tx': 13, 'success': 5, 'collisions': 8}, {'tx': 5, 'success': 0, 'collisions': 5}, {'tx': 8, 'success': 2, 'collisions': 6}, {'tx': 11, 'success': 5, 'collisions': 6}, {'tx': 8, 'success': 4, 'collisions': 4}, {'tx': 9, 'success': 4, 'collisions': 5}, {'tx': 10, 'success': 3, 'collisions': 7}, {'tx': 6, 'success': 2, 'collisions': 4}, {'tx': 3, 'success': 0, 'collisions': 3}, {'tx': 5, 'success': 1, 'collisions': 4}, {'tx': 4, 'success': 0, 'collisions': 4}, {'tx': 10, 'success': 4, 'collisions': 6}, {'tx': 10, 'success': 6, 'collisions': 4}, {'tx': 8, 'success': 1, 'collisions': 7}, {'tx': 16, 'success': 10, 'collisions': 6}]"
90,20,91,179,64,115,0.6424581005586593,0.3575418994413408,0.5824,"[{'tx': 4, 'success': 0, 'collisions': 4}, {'tx': 15, 'success': 9, 'collisions': 6}, {'tx': 7, 'success': 2, 'collisions': 5}, {'tx': 4, 'success': 0, 'collisions': 4}, {'tx': 9, 'success': 4, 'collisions': 5}, {'tx': 8, 'success': 3, 'collisions': 5}, {'tx': 8, 'success': 3, 'collisions': 5}, {'tx': 15, 'success': 6, 'collisions': 9}, {'tx': 8, 'success': 2, 'collisions': 6}, {'tx': 10, 'success': 4, 'collisions': 6}, {'tx': 9, 'success': 2, 'collisions': 7}, {'tx': 4, 'success': 0, 'collisions': 4}, {'tx': 10, 'success': 3, 'collisions': 7}, {'tx': 9, 'success': 4, 'collisions': 5}, {'tx': 5, 'success': 0, 'collisions': 5}, {'tx': 9, 'success': 3, 'collisions': 6}, {'tx': 9, 'success': 4, 'collisions': 5}, {'tx': 7, 'success': 1, 'collisions': 6}, {'tx': 14, 'success': 7, 'collisions': 7}, {'tx': 15, 'success': 7, 'collisions': 8}]"
91,20,92,168,67,101,0.6011904761904762,0.39880952380952384,0.6164,"[{'tx': 3, 'success': 0, 'collisions': 3}, {'tx': 6, 'success': 1, 'collisions': 5}, {'tx': 8, 'success': 3, 'collisions': 5}, {'tx': 15, 'success': 8, 'collisions': 7}, {'tx': 4, 'success': 1, 'collisions': 3}, {'tx': 4, 'success': 0, 'collisions': 4}, {'tx': 6, 'success': 2, 'collisions': 4}, {'tx': 9, 'success': 4, 'collisions': 5}, {'tx': 4, 'success': 0, 'collisions': 4}, {'tx': 10, 'success': 5, 'collisions': 5}, {'tx': 18, 'success': 10, 'collisions': 8}, {'tx': 14, 'success': 8, 'collisions': 6}, {'tx': 10, 'success': 4, 'collisions': 6}, {'tx': 4, 'success': 0, 'collisions': 4}, {'tx': 5, 'success': 1, 'collisions': 4}, {'tx': 11, 'success': 4, 'collisions': 7}, {'tx': 11, 'success': 4, 'collisions': 7}, {'tx': 7, 'success': 3, 'collisions': 4}, {'tx': 3, 'success': 0, 'collisions': 3}, {'tx': 16, 'success': 9, 'collisions': 7}]"
92,20,93,166,61,105,0.6325301204819277,0.3674698795180723,0.5673,"[{'tx': 6, 'success': 1, 'collisions': 5}, {'tx': 8, 'success': 2, 'collisions': 6}, {'tx': 8, 'success': 2, 'collisions': 6}, {'tx': 9, 'success': 3, 'collisions': 6}, {'tx': 9, 'success': 4, 'collisions': 5}, {'tx': 5, 'success': 1, 'collisions': 4}, {'tx': 7, 'success': 2, 'collisions': 5}, {'tx': 6, 'success': 1, 'collisions': 5}, {'tx': 11, 'success': 4, 'collisions': 7}, {'tx': 11, 'success': 6, 'collisions': 5}, {'tx': 12, 'success': 4, 'collisions': 8}, {'tx': 12, 'success': 6, 'collisions': 6}, {'tx': 5, 'success': 1, 'collisions': 4}, {'tx': 11, 'success': 7, 'collisions': 4}, {'tx': 6, 'success': 2, 'collisions': 4}, {'tx': 10, 'success': 4, 'collisions': 6}, {'tx': 15, 'success': 9, 'collisions': 6}, {'tx': 5, 'success': 1, 'collisions': 4}, {'tx': 6, 'success': 1, 'collisions': 5}, {'tx': 4, 'success': 0, 'collisions': 4}]"
93,20,94,168,60,108,0.6428571428571429,0.35714285714285715,0.564,"[{'tx': 6, 'success': 1, 'collisions': 5}, {'tx': 10, 'success': 4, 'collisions': 6}, {'tx': 7, 'success': 2, 'collisions': 5}, {'tx': 7, 'success': 1, 'collisions': 6}, {'tx': 12, 'success': 6, 'collisions': 6}, {'tx': 10, 'success': 5, 'collisions': 5}, {'tx': 8, 'success': 2, 'collisions': 6}, {'tx': 4, 'success': 0, 'collisions': 4}, {'tx': 6, 'success': 2, 'collisions': 4}, {'tx': 16, 'success': 8, 'collisions': 8}, {'tx': 6, 'success': 2, 'collisions': 4}, {'tx': 10, 'success': 2, 'collisions': 8}, {'tx': 4, 'success': 0, 'collisions': 4}, {'tx': 7, 'success': 3, 'collisions': 4}, {'tx': 11, 'success': 4, 'collisions': 7}, {'tx': 5, 'success': 1, 'collisions': 4}, {'tx': 8, 'success': 2, 'collisions': 6}, {'tx': 13, 'success': 7, 'collisions': 6}, {'tx': 9, 'success': 4, 'collisions': 5}, {'tx': 9, 'success': 4, 'collisions': 5}]"
94,20,95,171,66,105,0.6140350877192983,0.38596491228070173,0.627,"[{'tx': 3, 'success': 0, 'collisions': 3}, {'tx': 9, 'success': 3, 'collisions': 6}, {'tx': 7, 'success': 2, 'collisions': 5}, {'tx': 7, 'success': 1, 'collisions': 6}, {'tx': 13, 'success': 6, 'collisions': 7}, {'tx': 8, 'success': 3, 'collisions': 5}, {'tx': 10, 'success': 5, 'collisions': 5}, {'tx': 5, 'success': 1, 'collisions': 4}, {'tx': 6, 'success': 1, 'collisions': 5}, {'tx': 11, 'success': 6, 'collisions': 5}, {'tx': 13, 'success': 7, 'collisions': 6}, {'tx': 12, 'success': 6, 'collisions': 6}, {'tx': 6, 'success': 1, 'collisions': 5}, {'tx': 5, 'success': 0, 'collisions': 5}, {'tx': 5, 'success': 1, 'collisions': 4}, {'tx': 12, 'success': 5, 'collisions': 7}, {'tx': 8, 'success': 3, 'collisions': 5}, {'tx': 8, 'success': 2, 'collisions': 6}, {'tx': 12, 'success': 7, 'collisions': 5}, {'tx': 11, 'success': 6, 'collisions': 5}]"
95,20,96,160,58,102,0.6375,0.3625,0.5568,"[{'tx': 9, 'success': 3, 'collisions': 6}, {'tx': 4, 'success': 0, 'collisions': 4}, {'tx': 7, 'success': 2, 'collisions': 5}, {'tx': 7, 'success': 3, 'collisions': 4}, {'tx': 10, 'success': 3, 'collisions': 7}, {'tx': 8, 'success': 3, 'collisions': 5}, {'tx': 4, 'success': 0, 'collisions': 4}, {'tx': 4, 'success': 1, 'collisions': 3}, {'tx': 8, 'success': 2, 'collisions': 6}, {'tx': 4, 'success': 1, 'collisions': 3}, {'tx': 8, 'success': 3, 'collisions': 5}, {'tx': 15, 'success': 7, 'collisions': 8}, {'tx': 7, 'success': 2, 'collisions': 5}, {'tx': 9, 'success': 4, 'collisions': 5}, {'tx': 10, 'success': 4, 'collisions': 6}, {'tx': 11, 'success': 4, 'collisions': 7}, {'tx': 11, 'success': 5, 'collisions': 6}, {'tx': 11, 'success': 6, 'collisions': 5}, {'tx': 9, 'success': 5, 'collisions': 4}, {'tx': 4, 'success': 0, 'collisions': 4}]"
96,20,97,153,62,91,0.5947712418300654,0.40522875816993464,0.6014,"[{'tx': 6, 'success': 3, 'collisions': 3}, {'tx': 10, 'success': 5, 'collisions': 5}, {'tx': 8, 'success': 3, 'collisions': 5}, {'tx': 3, 'success': 0, 'collisions': 3}, {'tx': 11, 'success': 5, 'collisions': 6}, {'tx': 10, 'success': 6, 'collisions': 4}, {'tx': 7, 'success': 4, 'collisions': 3}, {'tx': 8, 'success': 2, 'collisions': 6}, {'tx': 10, 'success': 4, 'collisions': 6}, {'tx': 12, 'success': 8, 'collisions': 4}, {'tx': 5, 'success': 1, 'collisions': 4}, {'tx': 3, 'success': 0, 'collisions': 3}, {'tx': 8, 'success': 5, 'collisions': 3}, {'tx': 3, 'success': 0, 'collisions': 3}, {'tx': 4, 'success': 0, 'collisions': 4}, {'tx': 6, 'success': 1, 'collisions': 5}, {'tx': 9, 'success': 2, 'collisions': 7}, {'tx': 9, 'success': 3, 'collisions': 6}, {'tx': 11, 'success': 5, 'collisions': 6}, {'tx': 10, 'success': 5, 'collisions': 5}]"
97,20,98,162,58,104,0.6419753086419753,0.35802469135802467,0.5684,"[{'tx': 4, 'success': 1, 'collisions': 3}, {'tx': 11, 'success': 7, 'collisions': 4}, {'tx': 7, 'success': 2, 'collisions': 5}, {'tx': 13, 'success': 7, 'collisions': 6}, {'tx': 3, 'success': 0, 'collisions': 3}, {'tx': 7, 'success': 2, 'collisions': 5}, {'tx': 16, 'success': 9, 'collisions': 7}, {'tx': 12, 'success': 5, 'collisions': 7}, {'tx': 9, 'success': 3, 'collisions': 6}, {'tx': 10, 'success': 4, 'collisions': 6}, {'tx': 4, 'success': 0, 'collisions': 4}, {'tx': 8, 'success': 2, 'collisions': 6}, {'tx': 7, 'success': 2, 'collisions': 5}, {'tx': 9, 'success': 2, 'collisions': 7}, {'tx': 7, 'success': 2, 'collisions': 5}, {'tx': 6, 'success': 1, 'collisions': 5}, {'tx': 10, 'success': 4, 'collisions': 6}, {'tx': 6, 'success': 1, 'collisions': 5}, {'tx': 8, 'success': 4, 'collisions': 4}, {'tx': 5, 'success': 0, 'collisions': 5}]"
98,20,99,158,56,102,0.6455696202531646,0.35443037974683544,0.5544,"[{'tx': 9, 'success': 3, 'collisions': 6}, {'tx': 5, 'success': 1, 'collisions': 4}, {'tx': 7, 'success': 2, 'collisions': 5}, {'tx': 4, 'success': 0, 'collisions': 4}, {'tx': 5, 'success': 1, 'collisions': 4}, {'tx': 12, 'success': 6, 'collisions': 6}, {'tx': 12, 'success': 6, 'collisions': 6}, {'tx': 6, 'success': 1, 'collisions': 5}, {'tx': 8, 'success': 3, 'collisions': 5}, {'tx': 4, 'success': 0, 'collisions': 4}, {'tx': 5, 'success': 1, 'collisions': 4}, {'tx': 9, 'success': 2, 'collisions': 7}, {'tx': 5, 'success': 0, 'collisions': 5}, {'tx': 7, 'success': 1, 'collisions': 6}, {'tx': 10, 'success': 6, 'collisions': 4}, {'tx': 8, 'success': 4, 'collisions': 4}, {'tx': 14, 'success': 7, 'collisions': 7}, {'tx': 9, 'success': 3, 'collisions': 6}, {'tx': 12, 'success': 7, 'collisions': 5}, {'tx': 7, 'success': 2, 'collisions': 5}]"
99,20,100,160,54,106,0.6625,0.3375,0.54,"[{'tx': 13, 'success': 6, 'collisions': 7}, {'tx': 6, 'success': 1, 'collisions': 5}, {'tx': 15, 'success': 6, 'collisions': 9}, {'tx': 4, 'success': 0, 'collisions': 4}, {'tx': 13, 'success': 5, 'collisions': 8}, {'tx': 9, 'success': 4, 'collisions': 5}, {'tx': 4, 'success': 0, 'collisions': 4}, {'tx': 3, 'success': 0, 'collisions': 3}, {'tx': 10, 'success': 4, 'collisions': 6}, {'tx': 11, 'success': 4, 'collisions': 7}, {'tx': 4, 'success': 1, 'collisions': 3}, {'tx': 11, 'success': 5, 'collisions': 6}, {'tx': 4, 'success': 0, 'collisions': 4}, {'tx': 4, 'success': 0, 'collisions': 4}, {'tx': 5, 'success': 1, 'collisions': 4}, {'tx': 6, 'success': 1, 'collisions': 5}, {'tx': 10, 'success': 5, 'collisions': 5}, {'tx': 8, 'success': 1, 'collisions': 7}, {'tx': 5, 'success': 2, 'collisions': 3}, {'tx': 15, 'success': 8, 'collisions': 7}]"
100,30,1,7811,3652,4159,0.5324542312123928,0.46754576878760723,0.3652,"[{'tx': 95, 'success': 31, 'collisions': 64}, {'tx': 317, 'success': 162, 'collisions': 155}, {'tx': 304, 'success': 142, 'collisions': 162}, {'tx': 141, 'success': 62, 'collisions': 79}, {'tx': 343, 'success': 159, 'collisions': 184}, {'tx': 366, 'success': 173, 'collisions': 193}, {'tx': 303, 'success': 139, 'collisions': 164}, {'tx': 157, 'success': 65, 'collisions': 92}, {'tx': 244, 'success': 106, 'collisions': 138}, {'tx': 229, 'success': 98, 'collisions': 131}, {'tx': 164, 'success': 62, 'collisions': 102}, {'tx': 276, 'success': 128, 'collisions': 148}, {'tx': 281, 'success': 134, 'collisions': 147}, {'tx': 249, 'success': 119, 'collisions': 130}, {'tx': 332, 'success': 150, 'collisions': 182}, {'tx': 421, 'success': 210, 'collisions': 211}, {'tx': 202, 'success': 89, 'collisions': 113}, {'tx': 201, 'success': 85, 'collisions': 116}, {'tx': 275, 'success': 133, 'collisions': 142}, {'tx': 169, 'success': 81, 'collisions': 88}, {'tx': 156, 'success': 68, 'collisions': 88}, {'tx': 356, 'success': 179, 'collisions': 177}, {'tx': 250, 'success': 119, 'collisions': 131}, {'tx': 430, 'success': 215, 'collisions': 215}, {'tx': 288, 'success': 134, 'collisions': 154}, {'tx': 314, 'success': 153, 'collisions': 161}, {'tx': 337, 'success': 170, 'collisions': 167}, {'tx': 174, 'success': 79, 'collisions': 95}, {'tx': 142, 'success': 67, 'collisions': 75}, {'tx': 295, 'success': 140, 'collisions': 155}]"
101,30,2,4945,2351,2594,0.5245702730030334,0.4754297269969666,0.4702,"[{'tx': 169, 'success': 77, 'collisions': 92}, {'tx': 147, 'success': 70, 'collisions': 77}, {'tx': 129, 'success': 53, 'collisions': 76}, {'tx': 262, 'success': 133, 'collisions': 129}, {'tx': 56, 'success': 17, 'collisions': 39}, {'tx': 68, 'success': 23, 'collisions': 45}, {'tx': 260, 'success': 123, 'collisions': 137}, {'tx': 113, 'success': 43, 'collisions': 70}, {'tx': 161, 'success': 71, 'collisions': 90}, {'tx': 48, 'success': 17, 'collisions': 31}, {'tx': 222, 'success': 119, 'collisions': 103}, {'tx': 84, 'success': 38, 'collisions': 46}, {'tx': 133, 'success': 56, 'collisions': 77}, {'tx': 71, 'success': 28, 'collisions': 43}, {'tx': 159, 'success': 80, 'collisions': 79}, {'tx': 79, 'success': 33, 'collisions': 46}, {'tx': 263, 'success': 129, 'collisions': 134}, {'tx': 96, 'success': 34, 'collisions': 62}, {'tx': 212, 'success': 111, 'collisions': 101}, {'tx': 208, 'success': 117, 'collisions': 91}, {'tx': 255, 'success': 137, 'collisions': 118}, {'tx': 136, 'success': 69, 'collisions': 67}, {'tx': 187, 'success': 83, 'collisions': 104}, {'tx': 147, 'success': 69, 'collisions': 78}, {'tx': 158, 'success': 61, 'collisions': 97}, {'tx': 290, 'success': 155, 'collisions': 135}, {'tx': 215, 'success': 103, 'collisions': 112}, {'tx': 261, 'success': 131, 'collisions': 130}, {'tx': 220, 'success': 110, 'collisions': 110}, {'tx': 136, 'success': 61, 'collisions': 75}]"
102,30,3,3783,1788,1995,0.5273592386994449,0.4726407613005551,0.5364,"[{'tx': 113, 'success': 49, 'collisions': 64}, {'tx': 181, 'success': 94, 'collisions': 87}, {'tx': 195, 'success': 83, 'collisions': 112}, {'tx': 126, 'success': 66, 'collisions': 60}, {'tx': 68, 'success': 22, 'collisions': 46}, {'tx': 134, 'success': 64, 'collisions': 70}, {'tx': 57, 'success': 26, 'collisions': 31}, {'tx': 179, 'success': 88, 'collisions': 91}, {'tx': 120, 'success': 55, 'collisions': 65}, {'tx': 46, 'success': 17, 'collisions': 29}, {'tx': 86, 'success': 39, 'collisions': 47}, {'tx': 165, 'success': 77, 'collisions': 88}, {'tx': 97, 'success': 44, 'collisions': 53}, {'tx': 130, 'success': 64, 'collisions': 66}, {'tx': 90, 'success': 37, 'collisions': 53}, {'tx': 129, 'success': 53, 'collisions': 76}, {'tx': 125, 'success': 57, 'collisions': 68}, {'tx': 206, 'success': 105, 'collisions': 101}, {'tx': 115, 'success': 41, 'collisions': 74}, {'tx': 69, 'success': 25, 'collisions': 44}, {'tx': 48, 'success': 22, 'collisions': 26}, {'tx': 148, 'success': 74, 'collisions': 74}, {'tx': 223, 'success': 120, 'collisions': 103}, {'tx': 117, 'success': 50, 'collisions': 67}, {'tx': 135, 'success': 72, 'collisions': 63}, {'tx': 82, 'success': 40, 'collisions': 42}, {'tx': 135, 'success': 71, 'collisions': 64}, {'tx': 169, 'success': 83, 'collisions': 86}, {'tx': 103, 'success': 45, 'collisions': 58}, {'tx': 192, 'success': 105, 'collisions': 87}]"
103,30,4,2983,1349,1634,0.5477707006369427,0.45222929936305734,0.5396,"[{'tx': 39, 'success': 15, 'collisions': 24}, {'tx': 94, 'success': 44, 'collisions': 50}, {'tx': 116, 'success': 50, 'collisions': 66}, {'tx': 46, 'success': 19, 'collisions': 27}, {'tx': 106, 'success': 44, 'collisions': 62}, {'tx': 137, 'success': 60, 'collisions': 77}, {'tx': 59, 'success': 30, 'collisions': 29}, {'tx': 132, 'success': 60, 'collisions': 72}, {'tx': 53, 'success': 20, 'collisions': 33}, {'tx': 77, 'success': 37, 'collisions': 40}, {'tx': 142, 'success': 75, 'collisions': 67}, {'tx': 143, 'success': 72, 'collisions': 71}, {'tx': 147, 'success': 70, 'collisions': 77}, {'tx': 66, 'success': 34, 'collisions': 32}, {'tx': 113, 'success': 45, 'collisions': 68}, {'tx': 53, 'success': 25, 'collisions': 28}, {'tx': 88, 'success': 35, 'collisions': 53}, {'tx': 106, 'success': 45, 'collisions': 61}, {'tx': 122, 'success': 55, 'collisions': 67}, {'tx': 98, 'success': 40, 'collisions': 58}, {'tx': 79, 'success': 30, 'collisions': 49}, {'tx': 85, 'success': 37, 'collisions': 48}, {'tx': 119, 'success': 49, 'collisions': 70}, {'tx': 173, 'success': 94, 'collisions': 79}, {'tx': 62, 'success': 30, 'collisions': 32}, {'tx': 73, 'success': 25, 'collisions': 48}, {'tx': 152, 'success': 69, 'collisions': 83}, {'tx': 147, 'success': 73, 'collisions': 74}, {'tx': 123, 'success': 55, 'collisions': 68}, {'tx': 33, 'success': 12, 'collisions': 21}]"
104,30,5,2471,1134,1337,0.5410764872521246,0.45892351274787535,0.567,"[{'tx': 45, 'success': 17, 'collisions': 28}, {'tx': 27, 'success': 5, 'collisions': 22}, {'tx': 49, 'success': 12, 'collisions': 37}, {'tx': 147, 'success': 72, 'collisions': 75}, {'tx': 54, 'success': 21, 'collisions': 33}, {'tx': 26, 'success': 5, 'collisions': 21}, {'tx': 125, 'success': 65, 'collisions': 60}, {'tx': 110, 'success': 55, 'collisions': 55}, {'tx': 43, 'success': 14, 'collisions': 29}, {'tx': 121, 'success': 58, 'collisions': 63}, {'tx': 34, 'success': 13, 'collisions': 21}, {'tx': 28, 'success': 9, 'collisions': 19}, {'tx': 91, 'success': 45, 'collisions': 46}, {'tx': 86, 'success': 40, 'collisions': 46}, {'tx': 76, 'success': 29, 'collisions': 47}, {'tx': 61, 'success': 25, 'collisions': 36}, {'tx': 113, 'success': 54, 'collisions': 59}, {'tx': 65, 'success': 25, 'collisions': 40}, {'tx': 93, 'success': 42, 'collisions': 51}, {'tx': 109, 'success': 57, 'collisions': 52}, {'tx': 142, 'success': 75, 'collisions': 67}, {'tx': 19, 'success': 6, 'collisions': 13}, {'tx': 99, 'success': 49, 'collisions': 50}, {'tx': 65, 'success': 29, 'collisions': 36}, {'tx': 24, 'success': 7, 'collisions': 17}, {'tx': 106, 'success': 59, 'collisions': 47}, {'tx': 145, 'success': 70, 'collisions': 75}, {'tx': 97, 'success': 39, 'collisions': 58}, {'tx': 151, 'success': 79, 'collisions': 72}, {'tx': 120, 'success': 58, 'collisions': 62}]"
105,30,6,2110,952,1158,0.5488151658767773,0.45118483412322274,0.5712,"[{'tx': 39, 'success': 14, 'collisions': 25}, {'tx': 121, 'success': 59, 'collisions': 62}, {'tx': 9, 'success': 0, 'collisions': 9}, {'tx': 84, 'success': 38, 'collisions': 46}, {'tx': 137, 'success': 66, 'collisions': 71}, {'tx': 47, 'success': 17, 'collisions': 30}, {'tx': 106, 'success': 51, 'collisions': 55}, {'tx': 18, 'success': 4, 'collisions': 14}, {'tx': 132, 'success': 66, 'collisions': 66}, {'tx': 8, 'success': 0, 'collisions': 8}, {'tx': 105, 'success': 54, 'collisions': 51}, {'tx': 102, 'success': 48, 'collisions': 54}, {'tx': 11, 'success': 1, 'collisions': 10}, {'tx': 99, 'success': 50, 'collisions': 49}, {'tx': 48, 'success': 20, 'collisions': 28}, {'tx': 22, 'success': 7, 'collisions': 15}, {'tx': 108, 'success': 57, 'collisions': 51}, {'tx': 120, 'success': 60, 'collisions': 60}, {'tx': 38, 'success': 14, 'collisions': 24}, {'tx': 94, 'success': 43, 'collisions': 51}, {'tx': 50, 'success': 21, 'collisions': 29}, {'tx': 112, 'success': 50, 'collisions': 62}, {'tx': 60, 'success': 26, 'collisions': 34}, {'tx': 77, 'success': 35, 'collisions': 42}, {'tx': 38, 'success': 14, 'collisions': 24}, {'tx': 56, 'success': 23, 'collisions': 33}, {'tx': 74, 'success': 31, 'collisions': 43}, {'tx': 52, 'success': 21, 'collisions': 31}, {'tx': 125, 'success': 55, 'collisions': 70}, {'tx': 18, 'success': 7, 'collisions': 11}]"
106,30,7,1868,842,1026,0.5492505353319058,0.45074946466809424,0.5894,"[{'tx': 42, 'success': 13, 'collisions': 29}, {'tx': 91, 'success': 46, 'collisions': 45}, {'tx': 41, 'success': 21, 'collisions': 20}, {'tx': 98, 'success': 47, 'collisions': 51}, {'tx': 81, 'success': 43, 'collisions': 38}, {'tx': 67, 'success': 33, 'collisions': 34}, {'tx': 13, 'success': 2, 'collisions': 11}, {'tx': 22, 'success': 6, 'collisions': 16}, {'tx': 34, 'success': 14, 'collisions': 20}, {'tx': 71, 'success': 35, 'collisions': 36}, {'tx': 41, 'success': 17, 'collisions': 24}, {'tx': 97, 'success': 42, 'collisions': 55}, {'tx': 70, 'success': 31, 'collisions': 39}, {'tx': 89, 'success': 47, 'collisions': 42}, {'tx': 52, 'success': 24, 'collisions': 28}, {'tx': 65, 'success': 28, 'collisions': 37}, {'tx': 45, 'success': 16, 'collisions': 29}, {'tx': 79, 'success': 41, 'collisions': 38}, {'tx': 72, 'success': 30, 'collisions': 42}, {'tx': 100, 'success': 50, 'collisions': 50}, {'tx': 39, 'success': 14, 'collisions': 25}, {'tx': 87, 'success': 37, 'collisions': 50}, {'tx': 68, 'success': 28, 'collisions': 40}, {'tx': 69, 'success': 29, 'collisions': 40}, {'tx': 15, 'success': 4, 'collisions': 11}, {'tx': 77, 'success': 30, 'collisions': 47}, {'tx': 7, 'success': 0, 'collisions': 7}, {'tx': 110, 'success': 63, 'collisions': 47}, {'tx': 31, 'success': 10, 'collisions': 21}, {'tx': 95, 'success': 41, 'collisions': 54}]"
107,30,8,1640,743,897,0.5469512195121952,0.4530487804878049,0.5944,"[{'tx': 93, 'success': 41, 'collisions': 52}, {'tx': 33, 'success': 13, 'collisions': 20}, {'tx': 52, 'success': 21, 'collisions': 31}, {'tx': 42, 'success': 18, 'collisions': 24}, {'tx': 97, 'success': 48, 'collisions': 49}, {'tx': 71, 'success': 32, 'collisions': 39}, {'tx': 24, 'success': 11, 'collisions': 13}, {'tx': 7, 'success': 0, 'collisions': 7}, {'tx': 86, 'success': 38, 'collisions': 48}, {'tx': 63, 'success': 36, 'collisions': 27}, {'tx': 98, 'success': 54, 'collisions': 44}, {'tx': 71, 'success': 34, 'collisions': 37}, {'tx': 69, 'success': 32, 'collisions': 37}, {'tx': 54, 'success': 23, 'collisions': 31}, {'tx': 97, 'success': 43, 'collisions': 54}, {'tx': 48, 'success': 21, 'collisions': 27}, {'tx': 70, 'success': 34, 'collisions': 36}, {'tx': 47, 'success': 19, 'collisions': 28}, {'tx': 65, 'success': 27, 'collisions': 38}, {'tx': 69, 'success': 29, 'collisions': 40}, {'tx': 19, 'success': 4, 'collisions': 15}, {'tx': 26, 'success': 13, 'collisions': 13}, {'tx': 25, 'success': 7, 'collisions': 18}, {'tx': 50, 'success': 28, 'collisions': 22}, {'tx': 70, 'success': 34, 'collisions': 36}, {'tx': 7, 'success': 0, 'collisions': 7}, {'tx': 90, 'success': 41, 'collisions': 49}, {'tx': 7, 'success': 0, 'collisions': 7}, {'tx': 46, 'success': 24, 'collisions': 22}, {'tx': 44, 'success': 18, 'collisions': 26}]"
108,30,9,1523,654,869,0.5705843729481287,0.4294156270518713,0.5886,"[{'tx': 14, 'success': 2, 'collisions': 12}, {'tx': 74, 'success': 32, 'collisions': 42}, {'tx': 72, 'success': 38, 'collisions': 34}, {'tx': 50, 'success': 22, 'collisions': 28}, {'tx': 47, 'success': 20, 'collisions': 27}, {'tx': 14, 'success': 3, 'collisions': 11}, {'tx': 52, 'success': 20, 'collisions': 32}, {'tx': 31, 'success': 13, 'collisions': 18}, {'tx': 60, 'success': 26, 'collisions': 34}, {'tx': 41, 'success': 14, 'collisions': 27}, {'tx': 75, 'success': 32, 'collisions': 43}, {'tx': 94, 'success': 44, 'collisions': 50}, {'tx': 114, 'success': 59, 'collisions': 55}, {'tx': 83, 'success': 35, 'collisions': 48}, {'tx': 27, 'success': 8, 'collisions': 19}, {'tx': 41, 'success': 18, 'collisions': 23}, {'tx': 84, 'success': 41, 'collisions': 43}, {'tx': 64, 'success': 28, 'collisions': 36}, {'tx': 50, 'success': 20, 'collisions': 30}, {'tx': 83, 'success': 34, 'collisions': 49}, {'tx': 16, 'success': 3, 'collisions': 13}, {'tx': 21, 'success': 4, 'collisions': 17}, {'tx': 7, 'success': 0, 'collisions': 7}, {'tx': 66, 'success': 34, 'collisions': 32}, {'tx': 25, 'success': 8, 'collisions': 17}, {'tx': 47, 'success': 20, 'collisions': 27}, {'tx': 18, 'success': 4, 'collisions': 14}, {'tx': 22, 'success': 8, 'collisions': 14}, {'tx': 72, 'success': 32, 'collisions': 40}, {'tx': 59, 'success': 32, 'collisions': 27}]"
109,30,10,1355,611,744,0.5490774907749078,0.45092250922509225,0.611,"[{'tx': 78, 'success': 37, 'collisions': 41}, {'tx': 7, 'success': 0, 'collisions': 7}, {'tx': 50, 'success': 22, 'collisions': 28}, {'tx': 59, 'success': 28, 'collisions': 31}, {'tx': 60, 'success': 26, 'collisions': 34}, {'tx': 7, 'success': 0, 'collisions': 7}, {'tx': 7, 'success': 0, 'collisions': 7}, {'tx': 20, 'success': 7, 'collisions': 13}, {'tx': 47, 'success': 23, 'collisions': 24}, {'tx': 51, 'success': 23, 'collisions': 28}, {'tx': 46, 'success': 22, 'collisions': 24}, {'tx': 83, 'success': 41, 'collisions': 42}, {'tx': 75, 'success': 38, 'collisions': 37}, {'tx': 36, 'success': 10, 'collisions': 26}, {'tx': 61, 'success': 34, 'collisions': 27}, {'tx': 36, 'success': 13, 'collisions': 23}, {'tx': 40, 'success': 19, 'collisions': 21}, {'tx': 26, 'success': 7, 'collisions': 19}, {'tx': 39, 'success': 15, 'collisions': 24}, {'tx': 19, 'success': 5, 'collisions': 14}, {'tx': 31, 'success': 11, 'collisions': 20}, {'tx': 86, 'success': 50, 'collisions': 36}, {'tx': 36, 'success': 13, 'collisions': 23}, {'tx': 82, 'success': 42, 'collisions': 40}, {'tx': 69, 'success': 36, 'collisions': 33}, {'tx': 20, 'success': 8, 'collisions': 12}, {'tx': 73, 'success': 36, 'collisions': 37}, {'tx': 65, 'success': 28, 'collisions': 37}, {'tx': 14, 'success': 3, 'collisions': 11}, {'tx': 32, 'success': 14, 'collisions': 18}]"
110,30,11,1268,546,722,0.5694006309148265,0.4305993690851735,0.6006,"[{'tx': 66, 'success': 31, 'collisions': 35}, {'tx': 58, 'success': 23, 'collisions': 35}, {'tx': 6, 'success': 0, 'collisions': 6}, {'tx': 37, 'success': 17, 'collisions': 20}, {'tx': 28, 'success': 9, 'collisions': 19}, {'tx': 45, 'success': 20, 'collisions': 25}, {'tx': 41, 'success': 18, 'collisions': 23}, {'tx': 88, 'success': 45, 'collisions': 43}, {'tx': 13, 'success': 2, 'collisions': 11}, {'tx': 33, 'success': 12, 'collisions': 21}, {'tx': 33, 'success': 14, 'collisions': 19}, {'tx': 51, 'success': 21, 'collisions': 30}, {'tx': 7, 'success': 0, 'collisions': 7}, {'tx': 20, 'success': 6, 'collisions': 14}, {'tx': 37, 'success': 15, 'collisions': 22}, {'tx': 79, 'success': 40, 'collisions': 39}, {'tx': 62, 'success': 27, 'collisions': 35}, {'tx': 56, 'success': 27, 'collisions': 29}, {'tx': 10, 'success': 0, 'collisions': 10}, {'tx': 8, 'success': 1, 'collisions': 7}, {'tx': 53, 'success': 26, 'collisions': 27}, {'tx': 40, 'success': 12, 'collisions': 28}, {'tx': 61, 'success': 26, 'collisions': 35}, {'tx': 21, 'success': 4, 'collisions': 17}, {'tx': 73, 'success': 43, 'collisions': 30}, {'tx': 49, 'success': 21, 'collisions': 28}, {'tx': 97, 'success': 57, 'collisions': 40}, {'tx': 33, 'success': 11, 'collisions': 22}, {'tx': 32, 'success': 9, 'collisions': 23}, {'tx': 31, 'success': 9, 'collisions': 22}]"
111,30,12,1189,500,689,0.5794785534062237,0.42052144659377627,0.6,"[{'tx': 44, 'success': 16, 'collisions': 28}, {'tx': 33, 'success': 13, 'collisions': 20}, {'tx': 42, 'success': 19, 'collisions': 23}, {'tx': 59, 'success': 29, 'collisions': 30}, {'tx': 52, 'success': 21, 'collisions': 31}, {'tx': 33, 'success': 16, 'collisions': 17}, {'tx': 26, 'success': 5, 'collisions': 21}, {'tx': 59, 'success': 26, 'collisions': 33}, {'tx': 40, 'success': 20, 'collisions': 20}, {'tx': 43, 'success': 19, 'collisions': 24}, {'tx': 39, 'success': 15, 'collisions': 24}, {'tx': 68, 'success': 34, 'collisions': 34}, {'tx': 72, 'success': 35, 'collisions': 37}, {'tx': 56, 'success': 23, 'collisions': 33}, {'tx': 49, 'success': 20, 'collisions': 29}, {'tx': 67, 'success': 31, 'collisions': 36}, {'tx': 62, 'success': 31, 'collisions': 31}, {'tx': 51, 'success': 24, 'collisions': 27}, {'tx': 32, 'success': 11, 'collisions': 21}, {'tx': 13, 'success': 3, 'collisions': 10}, {'tx': 63, 'success': 28, 'collisions': 35}, {'tx': 7, 'success': 0, 'collisions': 7}, {'tx': 46, 'success': 21, 'collisions': 25}, {'tx': 25, 'success': 11, 'collisions': 14}, {'tx': 9, 'success': 1, 'collisions': 8}, {'tx': 13, 'success': 3, 'collisions': 10}, {'tx': 7, 'success': 0, 'collisions': 7}, {'tx': 41, 'success': 16, 'collisions': 25}, {'tx': 13, 'success': 3, 'collisions': 10}, {'tx': 25, 'success': 6, 'collisions': 19}]"
112,30,13,1089,453,636,0.5840220385674931,0.41597796143250687,0.5889,"[{'tx': 22, 'success': 7, 'collisions': 15}, {'tx': 78, 'success': 38, 'collisions': 40}, {'tx': 28, 'success': 12, 'collisions': 16}, {'tx': 55, 'success': 25, 'collisions': 30}, {'tx': 22, 'success': 6, 'collisions': 16}, {'tx': 57, 'success': 27, 'collisions': 30}, {'tx': 17, 'success': 6, 'collisions': 11}, {'tx': 12, 'success': 4, 'collisions': 8}, {'tx': 35, 'success': 15, 'collisions': 20}, {'tx': 32, 'success': 14, 'collisions': 18}, {'tx': 49, 'success': 21, 'collisions': 28}, {'tx': 24, 'success': 7, 'collisions': 17}, {'tx': 26, 'success': 9, 'collisions': 17}, {'tx': 19, 'success': 8, 'collisions': 11}, {'tx': 34, 'success': 14, 'collisions': 20}, {'tx': 33, 'success': 13, 'collisions': 20}, {'tx': 25, 'success': 9, 'collisions': 16}, {'tx': 46, 'success': 20, 'collisions': 26}, {'tx': 44, 'success': 18, 'collisions': 26}, {'tx': 57, 'success': 26, 'collisions': 31}, {'tx': 66, 'success': 30, 'collisions': 36}, {'tx': 21, 'success': 5, 'collisions': 16}, {'tx': 50, 'success': 23, 'collisions': 27}, {'tx': 18, 'success': 6, 'collisions': 12}, {'tx': 21, 'success': 7, 'collisions': 14}, {'tx': 49, 'success': 24, 'collisions': 25}, {'tx': 51, 'success': 22, 'collisions': 29}, {'tx': 37, 'success': 15, 'collisions': 22}, {'tx': 12, 'success': 2, 'collisions': 10}, {'tx': 49, 'success': 20, 'collisions': 29}]"
113,30,14,1009,444,565,0.5599603567888999,0.4400396432111001,0.6216,"[{'tx': 23, 'success': 7, 'collisions': 16}, {'tx': 16, 'success': 3, 'collisions': 13}, {'tx': 24, 'success': 7, 'collisions': 17}, {'tx': 7, 'success': 0, 'collisions': 7}, {'tx': 35, 'success': 17, 'collisions': 18}, {'tx': 41, 'success': 18, 'collisions': 23}, {'tx': 15, 'success': 7, 'collisions': 8}, {'tx': 6, 'success': 0, 'collisions': 6}, {'tx': 55, 'success': 23, 'collisions': 32}, {'tx': 39, 'success': 17, 'collisions': 22}, {'tx': 6, 'success': 0, 'collisions': 6}, {'tx': 30, 'success': 11, 'collisions': 19}, {'tx': 59, 'success': 29, 'collisions': 30}, {'tx': 61, 'success': 34, 'collisions': 27}, {'tx': 52, 'success': 23, 'collisions': 29}, {'tx': 42, 'success': 18, 'collisions': 24}, {'tx': 42, 'success': 24, 'collisions': 18}, {'tx': 59, 'success': 28, 'collisions': 31}, {'tx': 56, 'success': 30, 'collisions': 26}, {'tx': 40, 'success': 13, 'collisions': 27}, {'tx': 62, 'success': 32, 'collisions': 30}, {'tx': 6, 'success': 0, 'collisions': 6}, {'tx': 27, 'success': 13, 'collisions': 14}, {'tx': 21, 'success': 7, 'collisions': 14}, {'tx': 52, 'success': 25, 'collisions': 27}, {'tx': 31, 'success': 11, 'collisions': 20}, {'tx': 37, 'success': 20, 'collisions': 17}, {'tx': 24, 'success': 9, 'collisions': 15}, {'tx': 26, 'success': 13, 'collisions': 13}, {'tx': 15, 'success': 5, 'collisions': 10}]"
114,30,15,954,396,558,0.5849056603773585,0.41509433962264153,0.594,"[{'tx': 20, 'success': 4, 'collisions': 16}, {'tx': 46, 'success': 21, 'collisions': 25}, {'tx': 9, 'success': 1, 'collisions': 8}, {'tx': 45, 'success': 24, 'collisions': 21}, {'tx': 9, 'success': 1, 'collisions': 8}, {'tx': 38, 'success': 16, 'collisions': 22}, {'tx': 45, 'success': 19, 'collisions': 26}, {'tx': 39, 'success': 19, 'collisions': 20}, {'tx': 55, 'success': 31, 'collisions': 24}, {'tx': 50, 'success': 25, 'collisions': 25}, {'tx': 37, 'success': 18, 'collisions': 19}, {'tx': 12, 'success': 2, 'collisions': 10}, {'tx': 43, 'success': 15, 'collisions': 28}, {'tx': 55, 'success': 27, 'collisions': 28}, {'tx': 49, 'success': 22, 'collisions': 27}, {'tx': 15, 'success': 4, 'collisions': 11}, {'tx': 31, 'success': 11, 'collisions': 20}, {'tx': 59, 'success': 28, 'collisions': 31}, {'tx': 45, 'success': 22, 'collisions': 23}, {'tx': 20, 'success': 6, 'collisions': 14}, {'tx': 44, 'success': 21, 'collisions': 23}, {'tx': 9, 'success': 2, 'collisions': 7}, {'tx': 15, 'success': 2, 'collisions': 13}, {'tx': 34, 'success': 13, 'collisions': 21}, {'tx': 19, 'success': 5, 'collisions': 14}, {'tx': 37, 'success': 15, 'collisions': 22}, {'tx': 15, 'success': 4, 'collisions': 11}, {'tx': 14, 'success': 6, 'collisions': 8}, {'tx': 28, 'success': 8, 'collisions': 20}, {'tx': 17, 'success': 4, 'collisions': 13}]"
115,30,16,912,381,531,0.5822368421052632,0.41776315789473684,0.6096,"[{'tx': 40, 'success': 17, 'collisions': 23}, {'tx': 10, 'success': 2, 'collisions': 8}, {'tx': 44, 'success': 19, 'collisions': 25}, {'tx': 22, 'success': 9, 'collisions': 13}, {'tx': 41, 'success': 19, 'collisions': 22}, {'tx': 41, 'success': 19, 'collisions': 22}, {'tx': 19, 'success': 8, 'collisions': 11}, {'tx': 15, 'success': 3, 'collisions': 12}, {'tx': 36, 'success': 15, 'collisions': 21}, {'tx': 53, 'success': 30, 'collisions': 23}, {'tx': 22, 'success': 8, 'collisions': 14}, {'tx': 43, 'success': 17, 'collisions': 26}, {'tx': 49, 'success': 24, 'collisions': 25}, {'tx': 10, 'success': 3, 'collisions': 7}, {'tx': 40, 'success': 19, 'collisions': 21}, {'tx': 35, 'success': 14, 'collisions': 21}, {'tx': 12, 'success': 2, 'collisions': 10}, {'tx': 15, 'success': 5, 'collisions': 10}, {'tx': 43, 'success': 17, 'collisions': 26}, {'tx': 48, 'success': 20, 'collisions': 28}, {'tx': 37, 'success': 17, 'collisions': 20}, {'tx': 18, 'success': 4, 'collisions': 14}, {'tx': 25, 'success': 7, 'collisions': 18}, {'tx': 22, 'success': 6, 'collisions': 16}, {'tx': 47, 'success': 25, 'collisions': 22}, {'tx': 31, 'success': 15, 'collisions': 16}, {'tx': 20, 'success': 4, 'collisions': 16}, {'tx': 55, 'success': 30, 'collisions': 25}, {'tx': 9, 'success': 2, 'collisions': 7}, {'tx': 10, 'success': 1, 'collisions': 9}]"
116,30,17,864,350,514,0.5949074074074074,0.4050925925925926,0.595,"[{'tx': 20, 'success': 6, 'collisions': 14}, {'tx': 30, 'success': 11, 'collisions': 19}, {'tx': 32, 'success': 17, 'collisions': 15}, {'tx': 23, 'success': 8, 'collisions': 15}, {'tx': 18, 'success': 5, 'collisions': 13}, {'tx': 35, 'success': 11, 'collisions': 24}, {'tx': 36, 'success': 15, 'collisions': 21}, {'tx': 6, 'success': 0, 'collisions': 6}, {'tx': 7, 'success': 0, 'collisions': 7}, {'tx': 45, 'success': 21, 'collisions': 24}, {'tx': 18, 'success': 5, 'collisions': 13}, {'tx': 48, 'success': 22, 'collisions': 26}, {'tx': 19, 'success': 8, 'collisions': 11}, {'tx': 29, 'success': 8, 'collisions': 21}, {'tx': 17, 'success': 7, 'collisions': 10}, {'tx': 29, 'success': 10, 'collisions': 19}, {'tx': 20, 'success': 8, 'collisions': 12}, {'tx': 34, 'success': 12, 'collisions': 22}, {'tx': 31, 'success': 13, 'collisions': 18}, {'tx': 24, 'success': 9, 'collisions': 15}, {'tx': 76, 'success': 46, 'collisions': 30}, {'tx': 26, 'success': 10, 'collisions': 16}, {'tx': 16, 'success': 4, 'collisions': 12}, {'tx': 31, 'success': 12, 'collisions': 19}, {'tx': 50, 'success': 27, 'collisions': 23}, {'tx': 24, 'success': 7, 'collisions': 17}, {'tx': 35, 'success': 14, 'collisions': 21}, {'tx': 15, 'success': 4, 'collisions': 11}, {'tx': 29, 'success': 10, 'collisions': 19}, {'tx': 41, 'success': 20, 'collisions': 21}]"
117,30,18,829,320,509,0.6139927623642943,0.38600723763570566,0.576,"[{'tx': 9, 'success': 2, 'collisions': 7}, {'tx': 21, 'success': 8, 'collisions': 13}, {'tx': 13, 'success': 3, 'collisions': 10}, {'tx': 22, 'success': 5, 'collisions': 17}, {'tx': 26, 'success': 9, 'collisions': 17}, {'tx': 37, 'success': 12, 'collisions': 25}, {'tx': 10, 'success': 1, 'collisions': 9}, {'tx': 33, 'success': 10, 'collisions': 23}, {'tx': 20, 'success': 5, 'collisions': 15}, {'tx': 36, 'success': 17, 'collisions': 19}, {'tx': 39, 'success': 17, 'collisions': 22}, {'tx': 6, 'success': 0, 'collisions': 6}, {'tx': 15, 'success': 3, 'collisions': 12}, {'tx': 45, 'success': 19, 'collisions': 26}, {'tx': 33, 'success': 18, 'collisions': 15}, {'tx': 53, 'success': 27, 'collisions': 26}, {'tx': 27, 'success': 12, 'collisions': 15}, {'tx': 40, 'success': 17, 'collisions': 23}, {'tx': 10, 'success': 1, 'collisions': 9}, {'tx': 32, 'success': 14, 'collisions': 18}, {'tx': 26, 'success': 11, 'collisions': 15}, {'tx': 30, 'success': 13, 'collisions': 17}, {'tx': 32, 'success': 12, 'collisions': 20}, {'tx': 35, 'success': 16, 'collisions': 19}, {'tx': 14, 'success': 3, 'collisions': 11}, {'tx': 37, 'success': 17, 'collisions': 20}, {'tx': 22, 'success': 7, 'collisions': 15}, {'tx': 39, 'success': 15, 'collisions': 24}, {'tx': 42, 'success': 19, 'collisions': 23}, {'tx': 25, 'success': 7, 'collisions': 18}]"
118,30,19,769,315,454,0.5903771131339401,0.4096228868660598,0.5985,"[{'tx': 14, 'success': 2, 'collisions': 12}, {'tx': 36, 'success': 18, 'collisions': 18}, {'tx': 20, 'success': 8, 'collisions': 12}, {'tx': 13, 'success': 2, 'collisions': 11}, {'tx': 6, 'success': 0, 'collisions': 6}, {'tx': 40, 'success': 19, 'collisions': 21}, {'tx': 25, 'success': 9, 'collisions': 16}, {'tx': 24, 'success': 9, 'collisions': 15}, {'tx': 44, 'success': 21, 'collisions': 23}, {'tx': 24, 'success': 8, 'collisions': 16}, {'tx': 17, 'success': 7, 'collisions': 10}, {'tx': 26, 'success': 8, 'collisions': 18}, {'tx': 27, 'success': 10, 'collisions': 17}, {'tx': 16, 'success': 3, 'collisions': 13}, {'tx': 26, 'success': 11, 'collisions': 15}, {'tx': 21, 'success': 6, 'collisions': 15}, {'tx': 31, 'success': 13, 'collisions': 18}, {'tx': 20, 'success': 6, 'collisions': 14}, {'tx': 6, 'success': 0, 'collisions': 6}, {'tx': 18, 'success': 7, 'collisions': 11}, {'tx': 18, 'success': 7, 'collisions': 11}, {'tx': 42, 'success': 20, 'collisions': 22}, {'tx': 34, 'success': 17, 'collisions': 17}, {'tx': 35, 'success': 15, 'collisions': 20}, {'tx': 53, 'success': 26, 'collisions': 27}, {'tx': 22, 'success': 7, 'collisions': 15}, {'tx': 36, 'success': 16, 'collisions': 20}, {'tx': 43, 'success': 24, 'collisions': 19}, {'tx': 26, 'success': 16, 'collisions': 10}, {'tx': 6, 'success': 0, 'collisions': 6}]"
119,30,20,731,304,427,0.5841313269493844,0.4158686730506156,0.608,"[{'tx': 33, 'success': 15, 'collisions': 18}, {'tx': 6, 'success': 0, 'collisions': 6}, {'tx': 18, 'success': 7, 'collisions': 11}, {'tx': 27, 'success': 10, 'collisions': 17}, {'tx': 33, 'success': 13, 'collisions': 20}, {'tx': 24, 'success': 8, 'collisions': 16}, {'tx': 14, 'success': 4, 'collisions': 10}, {'tx': 29, 'success': 12, 'collisions': 17}, {'tx': 32, 'success': 18, 'collisions': 14}, {'tx': 32, 'success': 19, 'collisions': 13}, {'tx': 7, 'success': 0, 'collisions': 7}, {'tx': 6, 'success': 0, 'collisions': 6}, {'tx': 35, 'success': 18, 'collisions': 17}, {'tx': 8, 'success': 1, 'collisions': 7}, {'tx': 50, 'success': 30, 'collisions': 20}, {'tx': 30, 'success': 11, 'collisions': 19}, {'tx': 43, 'success': 21, 'collisions': 22}, {'tx': 31, 'success': 13, 'collisions': 18}, {'tx': 9, 'success': 1, 'collisions': 8}, {'tx': 13, 'success': 3, 'collisions': 10}, {'tx': 25, 'success': 10, 'collisions': 15}, {'tx': 7, 'success': 0, 'collisions': 7}, {'tx': 30, 'success': 14, 'collisions': 16}, {'tx': 13, 'success': 2, 'collisions': 11}, {'tx': 53, 'success': 28, 'collisions': 25}, {'tx': 24, 'success': 6, 'collisions': 18}, {'tx': 47, 'success': 21, 'collisions': 26}, {'tx': 22, 'success': 9, 'collisions': 13}, {'tx': 23, 'success': 9, 'collisions': 14}, {'tx': 7, 'success': 1, 'collisions': 6}]"
120,30,21,695,290,405,0.5827338129496403,0.4172661870503597,0.609,"[{'tx': 29, 'success': 12, 'collisions': 17}, {'tx': 29, 'success': 12, 'collisions': 17}, {'tx': 49, 'success': 27, 'collisions': 22}, {'tx': 20, 'success': 8, 'collisions': 12}, {'tx': 8, 'success': 1, 'collisions': 7}, {'tx': 28, 'success': 10, 'collisions': 18}, {'tx': 33, 'success': 17, 'collisions': 16}, {'tx': 36, 'success': 17, 'collisions': 19}, {'tx': 25, 'success': 7, 'collisions': 18}, {'tx': 5, 'success': 0, 'collisions': 5}, {'tx': 30, 'success': 11, 'collisions': 19}, {'tx': 42, 'success': 20, 'collisions': 22}, {'tx': 10, 'success': 2, 'collisions': 8}, {'tx': 19, 'success': 10, 'collisions': 9}, {'tx': 12, 'success': 3, 'collisions': 9}, {'tx': 9, 'success': 2, 'collisions': 7}, {'tx': 6, 'success': 1, 'collisions': 5}, {'tx': 6, 'success': 0, 'collisions': 6}, {'tx': 38, 'success': 18, 'collisions': 20}, {'tx': 5, 'success': 0, 'collisions': 5}, {'tx': 25, 'success': 10, 'collisions': 15}, {'tx': 6, 'success': 0, 'collisions': 6}, {'tx': 40, 'success': 24, 'collisions': 16}, {'tx': 19, 'success': 6, 'collisions': 13}, {'tx': 29, 'success': 15, 'collisions': 14}, {'tx': 6, 'success': 0, 'collisions': 6}, {'tx': 32, 'success': 14, 'collisions': 18}, {'tx': 15, 'success': 4, 'collisions': 11}, {'tx': 49, 'success': 24, 'collisions': 25}, {'tx': 35, 'success': 15, 'collisions': 20}]"
121,30,22,685,263,422,0.6160583941605839,0.38394160583941606,0.5786,"[{'tx': 9, 'success': 1, 'collisions': 8}, {'tx': 31, 'success': 14, 'collisions': 17}, {'tx': 6, 'success': 0, 'collisions': 6}, {'tx': 26, 'success': 12, 'collisions': 14}, {'tx': 6, 'success': 0, 'collisions': 6}, {'tx': 12, 'success': 2, 'collisions': 10}, {'tx': 20, 'success': 9, 'collisions': 11}, {'tx': 26, 'success': 8, 'collisions': 18}, {'tx': 13, 'success': 3, 'collisions': 10}, {'tx': 40, 'success': 20, 'collisions': 20}, {'tx': 19, 'success': 7, 'collisions': 12}, {'tx': 42, 'success': 18, 'collisions': 24}, {'tx': 21, 'success': 6, 'collisions': 15}, {'tx': 34, 'success': 15, 'collisions': 19}, {'tx': 26, 'success': 13, 'collisions': 13}, {'tx': 10, 'success': 2, 'collisions': 8}, {'tx': 15, 'success': 5, 'collisions': 10}, {'tx': 14, 'success': 2, 'collisions': 12}, {'tx': 20, 'success': 5, 'collisions': 15}, {'tx': 36, 'success': 17, 'collisions': 19}, {'tx': 27, 'success': 10, 'collisions': 17}, {'tx': 28, 'success': 9, 'collisions': 19}, {'tx': 32, 'success': 18, 'collisions': 14}, {'tx': 6, 'success': 0, 'collisions': 6}, {'tx': 40, 'success': 17, 'collisions': 23}, {'tx': 35, 'success': 17, 'collisions': 18}, {'tx': 12, 'success': 2, 'collisions': 10}, {'tx': 44, 'success': 22, 'collisions': 22}, {'tx': 27, 'success': 8, 'collisions': 19}, {'tx': 8, 'success': 1, 'collisions': 7}]"
122,30,23,660,257,403,0.6106060606060606,0.3893939393939394,0.5911,"[{'tx': 25, 'success': 10, 'collisions': 15}, {'tx': 16, 'success': 5, 'collisions': 11}, {'tx': 8, 'success': 1, 'collisions': 7}, {'tx': 5, 'success': 0, 'collisions': 5}, {'tx': 24, 'success': 7, 'collisions': 17}, {'tx': 6, 'success': 0, 'collisions': 6}, {'tx': 24, 'success': 10, 'collisions': 14}, {'tx': 38, 'success': 18, 'collisions': 20}, {'tx': 35, 'success': 14, 'collisions': 21}, {'tx': 26, 'success': 13, 'collisions': 13}, {'tx': 26, 'success': 12, 'collisions': 14}, {'tx': 19, 'success': 4, 'collisions': 15}, {'tx': 28, 'success': 13, 'collisions': 15}, {'tx': 27, 'success': 9, 'collisions': 18}, {'tx': 6, 'success': 0, 'collisions': 6}, {'tx': 40, 'success': 19, 'collisions': 21}, {'tx': 31, 'success': 13, 'collisions': 18}, {'tx': 22, 'success': 8, 'collisions': 14}, {'tx': 6, 'success': 0, 'collisions': 6}, {'tx': 29, 'success': 15, 'collisions': 14}, {'tx': 6, 'success': 0, 'collisions': 6}, {'tx': 12, 'success': 2, 'collisions': 10}, {'tx': 22, 'success': 9, 'collisions': 13}, {'tx': 5, 'success': 0, 'collisions': 5}, {'tx': 24, 'success': 9, 'collisions': 15}, {'tx': 25, 'success': 9, 'collisions': 16}, {'tx': 43, 'success': 20, 'collisions': 23}, {'tx': 39, 'success': 16, 'collisions': 23}, {'tx': 38, 'success': 21, 'collisions': 17}, {'tx': 5, 'success': 0, 'collisions': 5}]"
123,30,24,620,248,372,0.6,0.4,0.5952,"[{'tx': 20, 'success': 6, 'collisions': 14}, {'tx': 30, 'success': 15, 'collisions': 15}, {'tx': 35, 'success': 13, 'collisions': 22}, {'tx': 11, 'success': 3, 'collisions': 8}, {'tx': 11, 'success': 2, 'collisions': 9}, {'tx': 13, 'success': 3, 'collisions': 10}, {'tx': 11, 'success': 1, 'collisions': 10}, {'tx': 16, 'success': 5, 'collisions': 11}, {'tx': 19, 'success': 5, 'collisions': 14}, {'tx': 16, 'success': 5, 'collisions': 11}, {'tx': 33, 'success': 15, 'collisions': 18}, {'tx': 26, 'success': 9, 'collisions': 17}, {'tx': 18, 'success': 6, 'collisions': 12}, {'tx': 43, 'success': 24, 'collisions': 19}, {'tx': 8, 'success': 1, 'collisions': 7}, {'tx': 33, 'success': 15, 'collisions': 18}, {'tx': 28, 'success': 14, 'collisions': 14}, {'tx': 5, 'success': 0, 'collisions': 5}, {'tx': 20, 'success': 8, 'collisions': 12}, {'tx': 7, 'success': 1, 'collisions': 6}, {'tx': 14, 'success': 5, 'collisions': 9}, {'tx': 20, 'success': 8, 'collisions': 12}, {'tx': 28, 'success': 12, 'collisions': 16}, {'tx': 12, 'success': 4, 'collisions': 8}, {'tx': 33, 'success': 19, 'collisions': 14}, {'tx': 45, 'success': 23, 'collisions': 22}, {'tx': 6, 'success': 0, 'collisions': 6}, {'tx': 10, 'success': 3, 'collisions': 7}, {'tx': 36, 'success': 20, 'collisions': 16}, {'tx': 13, 'success': 3, 'collisions': 10}]"
124,30,25,609,238,371,0.6091954022988506,0.39080459770114945,0.595,"[{'tx': 36, 'success': 19, 'collisions': 17}, {'tx': 6, 'success': 0, 'collisions': 6}, {'tx': 14, 'success': 3, 'collisions': 11}, {'tx': 33, 'success': 14, 'collisions': 19}, {'tx': 19, 'success': 7, 'collisions': 12}, {'tx': 32, 'success': 12, 'collisions': 20}, {'tx': 31, 'success': 16, 'collisions': 15}, {'tx': 31, 'success': 14, 'collisions': 17}, {'tx': 6, 'success': 0, 'collisions': 6}, {'tx': 20, 'success': 7, 'collisions': 13}, {'tx': 31, 'success': 13, 'collisions': 18}, {'tx': 5, 'success': 0, 'collisions': 5}, {'tx': 22, 'success': 9, 'collisions': 13}, {'tx': 10, 'success': 2, 'collisions': 8}, {'tx': 21, 'success': 10, 'collisions': 11}, {'tx': 17, 'success': 4, 'collisions': 13}, {'tx': 15, 'success': 5, 'collisions': 10}, {'tx': 13, 'success': 2, 'collisions': 11}, {'tx': 13, 'success': 5, 'collisions': 8}, {'tx': 31, 'success': 14, 'collisions': 17}, {'tx': 34, 'success': 17, 'collisions': 17}, {'tx': 34, 'success': 16, 'collisions': 18}, {'tx': 8, 'success': 1, 'collisions': 7}, {'tx': 9, 'success': 1, 'collisions': 8}, {'tx': 15, 'success': 4, 'collisions': 11}, {'tx': 28, 'success': 14, 'collisions': 14}, {'tx': 21, 'success': 7, 'collisions': 14}, {'tx': 5, 'success': 0, 'collisions': 5}, {'tx': 33, 'success': 17, 'collisions': 16}, {'tx': 16, 'success': 5, 'collisions': 11}]"
125,30,26,582,232,350,0.6013745704467354,0.39862542955326463,0.6032,"[{'tx': 5, 'success': 0, 'collisions': 5}, {'tx': 30, 'success': 15, 'collisions': 15}, {'tx': 13, 'success': 4, 'collisions': 9}, {'tx': 5, 'success': 0, 'collisions': 5}, {'tx': 37, 'success': 19, 'collisions': 18}, {'tx': 8, 'success': 1, 'collisions': 7}, {'tx': 13, 'success': 4, 'collisions': 9}, {'tx': 12, 'success': 3, 'collisions': 9}, {'tx': 8, 'success': 1, 'collisions': 7}, {'tx': 13, 'success': 4, 'collisions': 9}, {'tx': 5, 'success': 0, 'collisions': 5}, {'tx': 16, 'success': 4, 'collisions': 12}, {'tx': 37, 'success': 17, 'collisions': 20}, {'tx': 8, 'success': 1, 'collisions': 7}, {'tx': 26, 'success': 10, 'collisions': 16}, {'tx': 28, 'success': 10, 'collisions': 18}, {'tx': 24, 'success': 9, 'collisions': 15}, {'tx': 18, 'success': 6, 'collisions': 12}, {'tx': 9, 'success': 2, 'collisions': 7}, {'tx': 19, 'success': 7, 'collisions': 12}, {'tx': 13, 'success': 4, 'collisions': 9}, {'tx': 14, 'success': 4, 'collisions': 10}, {'tx': 44, 'success': 24, 'collisions': 20}, {'tx': 26, 'success': 13, 'collisions': 13}, {'tx': 45, 'success': 25, 'collisions': 20}, {'tx': 16, 'success': 6, 'collisions': 10}, {'tx': 14, 'success': 4, 'collisions': 10}, {'tx': 7, 'success': 0, 'collisions': 7}, {'tx': 30, 'success': 13, 'collisions': 17}, {'tx': 39, 'success': 22, 'collisions': 17}]"
126,30,27,556,218,338,0.6079136690647482,0.3920863309352518,0.5886,"[{'tx': 13, 'success': 3, 'collisions': 10}, {'tx': 30, 'success': 14, 'collisions': 16}, {'tx': 9, 'success': 1, 'collisions': 8}, {'tx': 16, 'success': 6, 'collisions': 10}, {'tx': 6, 'success': 0, 'collisions': 6}, {'tx': 10, 'success': 2, 'collisions': 8}, {'tx': 16, 'success': 6, 'collisions': 10}, {'tx': 25, 'success': 12, 'collisions': 13}, {'tx': 6, 'success': 0, 'collisions': 6}, {'tx': 16, 'success': 6, 'collisions': 10}, {'tx': 17, 'success': 6, 'collisions': 11}, {'tx': 8, 'success': 1, 'collisions': 7}, {'tx': 40, 'success': 25, 'collisions': 15}, {'tx': 26, 'success': 11, 'collisions': 15}, {'tx': 33, 'success': 15, 'collisions': 18}, {'tx': 16, 'success': 4, 'collisions': 12}, {'tx': 9, 'success': 1, 'collisions': 8}, {'tx': 8, 'success': 1, 'collisions': 7}, {'tx': 19, 'success': 6, 'collisions': 13}, {'tx': 10, 'success': 3, 'collisions': 7}, {'tx': 16, 'success': 7, 'collisions': 9}, {'tx': 22, 'success': 10, 'collisions': 12}, {'tx': 20, 'success': 7, 'collisions': 13}, {'tx': 29, 'success': 12, 'collisions': 17}, {'tx': 31, 'success': 14, 'collisions': 17}, {'tx': 12, 'success': 2, 'collisions': 10}, {'tx': 23, 'success': 8, 'collisions': 15}, {'tx': 24, 'success': 11, 'collisions': 13}, {'tx': 40, 'success': 24, 'collisions': 16}, {'tx': 6, 'success': 0, 'collisions': 6}]"
127,30,28,541,210,331,0.6118299445471349,0.38817005545286504,0.588,"[{'tx': 36, 'success': 21, 'collisions': 15}, {'tx': 29, 'success': 15, 'collisions': 14}, {'tx': 21, 'success': 7, 'collisions': 14}, {'tx': 26, 'success': 12, 'collisions': 14}, {'tx': 8, 'success': 1, 'collisions': 7}, {'tx': 21, 'success': 6, 'collisions': 15}, {'tx': 16, 'success': 3, 'collisions': 13}, {'tx': 45, 'success': 28, 'collisions': 17}, {'tx': 5, 'success': 0, 'collisions': 5}, {'tx': 5, 'success': 0, 'collisions': 5}, {'tx': 5, 'success': 0, 'collisions': 5}, {'tx': 9, 'success': 1, 'collisions': 8}, {'tx': 34, 'success': 16, 'collisions': 18}, {'tx': 25, 'success': 11, 'collisions': 14}, {'tx': 17, 'success': 8, 'collisions': 9}, {'tx': 12, 'success': 2, 'collisions': 10}, {'tx': 9, 'success': 1, 'collisions': 8}, {'tx': 27, 'success': 13, 'collisions': 14}, {'tx': 17, 'success': 5, 'collisions': 12}, {'tx': 5, 'success': 0, 'collisions': 5}, {'tx': 22, 'success': 10, 'collisions': 12}, {'tx': 23, 'success': 9, 'collisions': 14}, {'tx': 9, 'success': 1, 'collisions': 8}, {'tx': 36, 'success': 17, 'collisions': 19}, {'tx': 11, 'success': 2, 'collisions': 9}, {'tx': 7, 'success': 0, 'collisions': 7}, {'tx': 6, 'success': 0, 'collisions': 6}, {'tx': 11, 'success': 3, 'collisions': 8}, {'tx': 24, 'success': 10, 'collisions': 14}, {'tx': 20, 'success': 8, 'collisions': 12}]"
128,30,29,514,212,302,0.5875486381322957,0.41245136186770426,0.6148,"[{'tx': 9, 'success': 2, 'collisions': 7}, {'tx': 26, 'success': 13, 'collisions': 13}, {'tx': 7, 'success': 1, 'collisions': 6}, {'tx': 6, 'success': 0, 'collisions': 6}, {'tx': 11, 'success': 3, 'collisions': 8}, {'tx': 25, 'success': 11, 'collisions': 14}, {'tx': 11, 'success': 4, 'collisions': 7}, {'tx': 15, 'success': 7, 'collisions': 8}, {'tx': 17, 'success': 5, 'collisions': 12}, {'tx': 25, 'success': 16, 'collisions': 9}, {'tx': 5, 'success': 0, 'collisions': 5}, {'tx': 13, 'success': 3, 'collisions': 10}, {'tx': 17, 'success': 7, 'collisions': 10}, {'tx': 19, 'success': 10, 'collisions': 9}, {'tx': 17, 'success': 6, 'collisions': 11}, {'tx': 24, 'success': 12, 'collisions': 12}, {'tx': 5, 'success': 0, 'collisions': 5}, {'tx': 24, 'success': 11, 'collisions': 13}, {'tx': 5, 'success': 0, 'collisions': 5}, {'tx': 26, 'success': 13, 'collisions': 13}, {'tx': 14, 'success': 4, 'collisions': 10}, {'tx': 11, 'success': 2, 'collisions': 9}, {'tx': 27, 'success': 12, 'collisions': 15}, {'tx': 30, 'success': 16, 'collisions': 14}, {'tx': 5, 'success': 0, 'collisions': 5}, {'tx': 6, 'success': 0, 'collisions': 6}, {'tx': 25, 'success': 8, 'collisions': 17}, {'tx': 42, 'success': 24, 'collisions': 18}, {'tx': 11, 'success': 3, 'collisions': 8}, {'tx': 36, 'success': 19, 'collisions': 17}]"
129,30,30,520,195,325,0.625,0.375,0.585,"[{'tx': 11, 'success': 3, 'collisions': 8}, {'tx': 17, 'success': 6, 'collisions': 11}, {'tx': 11, 'success': 2, 'collisions': 9}, {'tx': 21, 'success': 10, 'collisions': 11}, {'tx': 20, 'success': 6, 'collisions': 14}, {'tx': 11, 'success': 3, 'collisions': 8}, {'tx': 25, 'success': 11, 'collisions': 14}, {'tx': 26, 'success': 10, 'collisions': 16}, {'tx': 5, 'success': 0, 'collisions': 5}, {'tx': 20, 'success': 8, 'collisions': 12}, {'tx': 19, 'success': 5, 'collisions': 14}, {'tx': 13, 'success': 2, 'collisions': 11}, {'tx': 39, 'success': 21, 'collisions': 18}, {'tx': 27, 'success': 14, 'collisions': 13}, {'tx': 11, 'success': 2, 'collisions': 9}, {'tx': 29, 'success': 16, 'collisions': 13}, {'tx': 23, 'success': 8, 'collisions': 15}, {'tx': 5, 'success': 0, 'collisions': 5}, {'tx': 29, 'success': 13, 'collisions': 16}, {'tx': 5, 'success': 0, 'collisions': 5}, {'tx': 10, 'success': 2, 'collisions': 8}, {'tx': 18, 'success': 6, 'collisions': 12}, {'tx': 5, 'success': 0, 'collisions': 5}, {'tx': 5, 'success': 0, 'collisions': 5}, {'tx': 13, 'success': 3, 'collisions': 10}, {'tx': 22, 'success': 10, 'collisions': 12}, {'tx': 20, 'success': 9, 'collisions': 11}, {'tx': 28, 'success': 11, 'collisions': 17}, {'tx': 11, 'success': 3, 'collisions': 8}, {'tx': 21, 'success': 11, 'collisions': 10}]"
130,30,31,504,188,316,0.626984126984127,0.373015873015873,0.5828,"[{'tx': 6, 'success': 0, 'collisions': 6}, {'tx': 5, 'success': 0, 'collisions': 5}, {'tx': 15, 'success': 4, 'collisions': 11}, {'tx': 17, 'success': 6, 'collisions': 11}, {'tx': 17, 'success': 5, 'collisions': 12}, {'tx': 37, 'success': 18, 'collisions': 19}, {'tx': 16, 'success': 4, 'collisions': 12}, {'tx': 17, 'success': 6, 'collisions': 11}, {'tx': 13, 'success': 5, 'collisions': 8}, {'tx': 14, 'success': 3, 'collisions': 11}, {'tx': 22, 'success': 9, 'collisions': 13}, {'tx': 40, 'success': 22, 'collisions': 18}, {'tx': 12, 'success': 6, 'collisions': 6}, {'tx': 22, 'success': 7, 'collisions': 15}, {'tx': 5, 'success': 0, 'collisions': 5}, {'tx': 18, 'success': 8, 'collisions': 10}, {'tx': 21, 'success': 10, 'collisions': 11}, {'tx': 10, 'success': 2, 'collisions': 8}, {'tx': 21, 'success': 8, 'collisions': 13}, {'tx': 5, 'success': 0, 'collisions': 5}, {'tx': 5, 'success': 0, 'collisions': 5}, {'tx': 28, 'success': 14, 'collisions': 14}, {'tx': 16, 'success': 4, 'collisions': 12}, {'tx': 16, 'success': 7, 'collisions': 9}, {'tx': 6, 'success': 1, 'collisions': 5}, {'tx': 14, 'success': 5, 'collisions': 9}, {'tx': 15, 'success': 3, 'collisions': 12}, {'tx': 21, 'success': 9, 'collisions': 12}, {'tx': 27, 'success': 13, 'collisions': 14}, {'tx': 23, 'success': 9, 'collisions': 14}]"
131,30,32,483,184,299,0.6190476190476191,0.38095238095238093,0.5888,"[{'tx': 17, 'success': 5, 'collisions': 12}, {'tx': 23, 'success': 11, 'collisions': 12}, {'tx': 5, 'success': 0, 'collisions': 5}, {'tx': 23, 'success': 11, 'collisions': 12}, {'tx': 30, 'success': 16, 'collisions': 14}, {'tx': 5, 'success': 0, 'collisions': 5}, {'tx': 17, 'success': 6, 'collisions': 11}, {'tx': 5, 'success': 0, 'collisions': 5}, {'tx': 10, 'success': 2, 'collisions': 8}, {'tx': 19, 'success': 8, 'collisions': 11}, {'tx': 19, 'success': 8, 'collisions': 11}, {'tx': 5, 'success': 0, 'collisions': 5}, {'tx': 31, 'success': 15, 'collisions': 16}, {'tx': 37, 'success': 18, 'collisions': 19}, {'tx': 17, 'success': 5, 'collisions': 12}, {'tx': 8, 'success': 1, 'collisions': 7}, {'tx': 32, 'success': 20, 'collisions': 12}, {'tx': 14, 'success': 5, 'collisions': 9}, {'tx': 7, 'success': 0, 'collisions': 7}, {'tx': 5, 'success': 0, 'collisions': 5}, {'tx': 19, 'success': 7, 'collisions': 12}, {'tx': 18, 'success': 7, 'collisions': 11}, {'tx': 22, 'success': 8, 'collisions': 14}, {'tx': 19, 'success': 7, 'collisions': 12}, {'tx': 5, 'success': 0, 'collisions': 5}, {'tx': 8, 'success': 1, 'collisions': 7}, {'tx': 24, 'success': 11, 'collisions': 13}, {'tx': 24, 'success': 10, 'collisions': 14}, {'tx': 5, 'success': 0, 'collisions': 5}, {'tx': 10, 'success': 2, 'collisions': 8}]"
132,30,33,483,181,302,0.6252587991718427,0.3747412008281574,0.5973,"[{'tx': 19, 'success': 7, 'collisions': 12}, {'tx': 6, 'success': 0, 'collisions': 6}, {'tx': 9, 'success': 2, 'collisions': 7}, {'tx': 20, 'success': 8, 'collisions': 12}, {'tx': 23, 'success': 10, 'collisions': 13}, {'tx': 5, 'success': 0, 'collisions': 5}, {'tx': 9, 'success': 2, 'collisions': 7}, {'tx': 10, 'success': 2, 'collisions': 8}, {'tx': 21, 'success': 8, 'collisions': 13}, {'tx': 10, 'success': 2, 'collisions': 8}, {'tx': 7, 'success': 1, 'collisions': 6}, {'tx': 26, 'success': 12, 'collisions': 14}, {'tx': 15, 'success': 6, 'collisions': 9}, {'tx': 17, 'success': 5, 'collisions': 12}, {'tx': 23, 'success': 9, 'collisions': 14}, {'tx': 27, 'success': 13, 'collisions': 14}, {'tx': 5, 'success': 0, 'collisions': 5}, {'tx': 33, 'success': 18, 'collisions': 15}, {'tx': 23, 'success': 11, 'collisions': 12}, {'tx': 23, 'success': 10, 'collisions': 13}, {'tx': 11, 'success': 2, 'collisions': 9}, {'tx': 21, 'success': 9, 'collisions': 12}, {'tx': 8, 'success': 1, 'collisions': 7}, {'tx': 20, 'success': 7, 'collisions': 13}, {'tx': 21, 'success': 11, 'collisions': 10}, {'tx': 9, 'success': 1, 'collisions': 8}, {'tx': 6, 'success': 0, 'collisions': 6}, {'tx': 13, 'success': 5, 'collisions': 8}, {'tx': 13, 'success': 4, 'collisions': 9}, {'tx': 30, 'success': 15, 'collisions': 15}]"
133,30,34,468,163,305,0.6517094017094017,0.3482905982905983,0.5542,"[{'tx': 5, 'success': 0, 'collisions': 5}, {'tx': 9, 'success': 1, 'collisions': 8}, {'tx': 29, 'success': 14, 'collisions': 15}, {'tx': 19, 'success': 7, 'collisions': 12}, {'tx': 18, 'success': 8, 'collisions': 10}, {'tx': 15, 'success': 5, 'collisions': 10}, {'tx': 15, 'success': 4, 'collisions': 11}, {'tx': 17, 'success': 7, 'collisions': 10}, {'tx': 24, 'success': 9, 'collisions': 15}, {'tx': 11, 'success': 2, 'collisions': 9}, {'tx': 22, 'success': 11, 'collisions': 11}, {'tx': 15, 'success': 7, 'collisions': 8}, {'tx': 18, 'success': 7, 'collisions': 11}, {'tx': 17, 'success': 6, 'collisions': 11}, {'tx': 6, 'success': 0, 'collisions': 6}, {'tx': 13, 'success': 4, 'collisions': 9}, {'tx': 21, 'success': 8, 'collisions': 13}, {'tx': 7, 'success': 1, 'collisions': 6}, {'tx': 11, 'success': 2, 'collisions': 9}, {'tx': 5, 'success': 0, 'collisions': 5}, {'tx': 20, 'success': 7, 'collisions': 13}, {'tx': 17, 'success': 6, 'collisions': 11}, {'tx': 29, 'success': 12, 'collisions': 17}, {'tx': 13, 'success': 3, 'collisions': 10}, {'tx': 5, 'success': 0, 'collisions': 5}, {'tx': 5, 'success': 0, 'collisions': 5}, {'tx': 27, 'success': 13, 'collisions': 14}, {'tx': 15, 'success': 5, 'collisions': 10}, {'tx': 24, 'success': 9, 'collisions': 15}, {'tx': 16, 'success': 5, 'collisions': 11}]"
134,30,35,450,171,279,0.62,0.38,0.5985,"[{'tx': 16, 'success': 7, 'collisions': 9}, {'tx': 14, 'success': 4, 'collisions': 10}, {'tx': 18, 'success': 6, 'collisions': 12}, {'tx': 17, 'success': 6, 'collisions': 11}, {'tx': 11, 'success': 4, 'collisions': 7}, {'tx': 7, 'success': 1, 'collisions': 6}, {'tx': 5, 'success': 0, 'collisions': 5}, {'tx': 6, 'success': 1, 'collisions': 5}, {'tx': 16, 'success': 7, 'collisions': 9}, {'tx': 20, 'success': 7, 'collisions': 13}, {'tx': 10, 'success': 3, 'collisions': 7}, {'tx': 18, 'success': 8, 'collisions': 10}, {'tx': 27, 'success': 14, 'collisions': 13}, {'tx': 20, 'success': 8, 'collisions': 12}, {'tx': 23, 'success': 10, 'collisions': 13}, {'tx': 6, 'success': 0, 'collisions': 6}, {'tx': 12, 'success': 4, 'collisions': 8}, {'tx': 8, 'success': 1, 'collisions': 7}, {'tx': 21, 'success': 8, 'collisions': 13}, {'tx': 24, 'success': 11, 'collisions': 13}, {'tx': 24, 'success': 12, 'collisions': 12}, {'tx': 35, 'success': 21, 'collisions': 14}, {'tx': 20, 'success': 9, 'collisions': 11}, {'tx': 8, 'success': 1, 'collisions': 7}, {'tx': 10, 'success': 3, 'collisions': 7}, {'tx': 5, 'success': 0, 'collisions': 5}, {'tx': 20, 'success': 8, 'collisions': 12}, {'tx': 9, 'success': 2, 'collisions': 7}, {'tx': 6, 'success': 0, 'collisions': 6}, {'tx': 14, 'success': 5, 'collisions': 9}]"
135,30,36,441,158,283,0.6417233560090703,0.35827664399092973,0.5688,"[{'tx': 8, 'success': 1, 'collisions': 7}, {'tx': 5, 'success': 0, 'collisions': 5}, {'tx': 10, 'success': 2, 'collisions': 8}, {'tx': 7, 'success': 1, 'collisions': 6}, {'tx': 9, 'success': 1, 'collisions': 8}, {'tx': 9, 'success': 2, 'collisions': 7}, {'tx': 22, 'success': 10, 'collisions': 12}, {'tx': 14, 'success': 5, 'collisions': 9}, {'tx': 32, 'success': 15, 'collisions': 17}, {'tx': 6, 'success': 0, 'collisions': 6}, {'tx': 14, 'success': 5, 'collisions': 9}, {'tx': 5, 'success': 0, 'collisions': 5}, {'tx': 11, 'success': 3, 'collisions': 8}, {'tx': 15, 'success': 7, 'collisions': 8}, {'tx': 28, 'success': 14, 'collisions': 14}, {'tx': 26, 'success': 9, 'collisions': 17}, {'tx': 24, 'success': 10, 'collisions': 14}, {'tx': 23, 'success': 9, 'collisions': 14}, {'tx': 5, 'success': 0, 'collisions': 5}, {'tx': 14, 'success': 4, 'collisions': 10}, {'tx': 10, 'success': 3, 'collisions': 7}, {'tx': 13, 'success': 4, 'collisions': 9}, {'tx': 4, 'success': 0, 'collisions': 4}, {'tx': 21, 'success': 9, 'collisions': 12}, {'tx': 23, 'success': 11, 'collisions': 12}, {'tx': 9, 'success': 2, 'collisions': 7}, {'tx': 21, 'success': 10, 'collisions': 11}, {'tx': 22, 'success': 11, 'collisions': 11}, {'tx': 18, 'success': 6, 'collisions': 12}, {'tx': 13, 'success': 4, 'collisions': 9}]"
136,30,37,431,151,280,0.6496519721577726,0.3503480278422274,0.5587,"[{'tx': 11, 'success': 4, 'collisions': 7}, {'tx': 10, 'success': 1, 'collisions': 9}, {'tx': 5, 'success': 0, 'collisions': 5}, {'tx': 13, 'success': 6, 'collisions': 7}, {'tx': 29, 'success': 15, 'collisions': 14}, {'tx': 22, 'success': 9, 'collisions': 13}, {'tx': 16, 'success': 5, 'collisions': 11}, {'tx': 23, 'success': 11, 'collisions': 12}, {'tx': 20, 'success': 7, 'collisions': 13}, {'tx': 15, 'success': 7, 'collisions': 8}, {'tx': 19, 'success': 6, 'collisions': 13}, {'tx': 11, 'success': 2, 'collisions': 9}, {'tx': 14, 'success': 4, 'collisions': 10}, {'tx': 6, 'success': 1, 'collisions': 5}, {'tx': 5, 'success': 0, 'collisions': 5}, {'tx': 24, 'success': 12, 'collisions': 12}, {'tx': 14, 'success': 4, 'collisions': 10}, {'tx': 12, 'success': 3, 'collisions': 9}, {'tx': 5, 'success': 0, 'collisions': 5}, {'tx': 27, 'success': 13, 'collisions': 14}, {'tx': 9, 'success': 1, 'collisions': 8}, {'tx': 15, 'success': 4, 'collisions': 11}, {'tx': 16, 'success': 7, 'collisions': 9}, {'tx': 6, 'success': 0, 'collisions': 6}, {'tx': 4, 'success': 0, 'collisions': 4}, {'tx': 5, 'success': 0, 'collisions': 5}, {'tx': 21, 'success': 7, 'collisions': 14}, {'tx': 26, 'success': 12, 'collisions': 14}, {'tx': 13, 'success': 4, 'collisions': 9}, {'tx': 15, 'success': 6, 'collisions': 9}]"
137,30,38,415,148,267,0.6433734939759036,0.3566265060240964,0.5624,"[{'tx': 10, 'success': 2, 'collisions': 8}, {'tx': 7, 'success': 1, 'collisions': 6}, {'tx': 5, 'success': 1, 'collisions': 4}, {'tx': 19, 'success': 8, 'collisions': 11}, {'tx': 15, 'success': 5, 'collisions': 10}, {'tx': 9, 'success': 1, 'collisions': 8}, {'tx': 16, 'success': 5, 'collisions': 11}, {'tx': 9, 'success': 1, 'collisions': 8}, {'tx': 5, 'success': 0, 'collisions': 5}, {'tx': 17, 'success': 9, 'collisions': 8}, {'tx': 5, 'success': 0, 'collisions': 5}, {'tx': 24, 'success': 11, 'collisions': 13}, {'tx': 7, 'success': 1, 'collisions': 6}, {'tx': 22, 'success': 9, 'collisions': 13}, {'tx': 12, 'success': 5, 'collisions': 7}, {'tx': 10, 'success': 3, 'collisions': 7}, {'tx': 9, 'success': 1, 'collisions': 8}, {'tx': 23, 'success': 10, 'collisions': 13}, {'tx': 10, 'success': 4, 'collisions': 6}, {'tx': 29, 'success': 14, 'collisions': 15}, {'tx': 6, 'success': 1, 'collisions': 5}, {'tx': 31, 'success': 17, 'collisions': 14}, {'tx': 16, 'success': 6, 'collisions': 10}, {'tx': 10, 'success': 2, 'collisions': 8}, {'tx': 20, 'success': 9, 'collisions': 11}, {'tx': 9, 'success': 2, 'collisions': 7}, {'tx': 5, 'success': 0, 'collisions': 5}, {'tx': 24, 'success': 11, 'collisions': 13}, {'tx': 14, 'success': 4, 'collisions': 10}, {'tx': 17, 'success': 5, 'collisions': 12}]"
138,30,39,404,144,260,0.6435643564356436,0.3564356435643564,0.5616,"[{'tx': 25, 'success': 15, 'collisions': 10}, {'tx': 20, 'success': 8, 'collisions': 12}, {'tx': 15, 'success': 4, 'collisions': 11}, {'tx': 11, 'success': 3, 'collisions': 8}, {'tx': 11, 'success': 3, 'collisions': 8}, {'tx': 8, 'success': 1, 'collisions': 7}, {'tx': 19, 'success': 8, 'collisions': 11}, {'tx': 5, 'success': 0, 'collisions': 5}, {'tx': 5, 'success': 0, 'collisions': 5}, {'tx': 20, 'success': 8, 'collisions': 12}, {'tx': 24, 'success': 13, 'collisions': 11}, {'tx': 10, 'success': 2, 'collisions': 8}, {'tx': 21, 'success': 10, 'collisions': 11}, {'tx': 14, 'success': 5, 'collisions': 9}, {'tx': 19, 'success': 8, 'collisions': 11}, {'tx': 8, 'success': 1, 'collisions': 7}, {'tx': 7, 'success': 1, 'collisions': 6}, {'tx': 30, 'success': 13, 'collisions': 17}, {'tx': 16, 'success': 5, 'collisions': 11}, {'tx': 8, 'success': 1, 'collisions': 7}, {'tx': 7, 'success': 1, 'collisions': 6}, {'tx': 21, 'success': 10, 'collisions': 11}, {'tx': 14, 'success': 6, 'collisions': 8}, {'tx': 7, 'success': 1, 'collisions': 6}, {'tx': 10, 'success': 3, 'collisions': 7}, {'tx': 9, 'success': 4, 'collisions': 5}, {'tx': 6, 'success': 0, 'collisions': 6}, {'tx': 11, 'success': 2, 'collisions': 9}, {'tx': 16, 'success': 5, 'collisions': 11}, {'tx': 7, 'success': 3, 'collisions': 4}]"
139,30,40,397,139,258,0.6498740554156172,0.3501259445843829,0.556,"[{'tx': 12, 'success': 3, 'collisions': 9}, {'tx': 9, 'success': 2, 'collisions': 7}, {'tx': 16, 'success': 6, 'collisions': 10}, {'tx': 5, 'success': 0, 'collisions': 5}, {'tx': 17, 'success': 7, 'collisions': 10}, {'tx': 21, 'success': 10, 'collisions': 11}, {'tx': 13, 'success': 3, 'collisions': 10}, {'tx': 16, 'success': 7, 'collisions': 9}, {'tx': 8, 'success': 2, 'collisions': 6}, {'tx': 5, 'success': 0, 'collisions': 5}, {'tx': 14, 'success': 5, 'collisions': 9}, {'tx': 18, 'success': 6, 'collisions': 12}, {'tx': 17, 'success': 9, 'collisions': 8}, {'tx': 13, 'success': 4, 'collisions': 9}, {'tx': 14, 'success': 5, 'collisions': 9}, {'tx': 18, 'success': 10, 'collisions': 8}, {'tx': 24, 'success': 13, 'collisions': 11}, {'tx': 11, 'success': 3, 'collisions': 8}, {'tx': 13, 'success': 3, 'collisions': 10}, {'tx': 17, 'success': 6, 'collisions': 11}, {'tx': 22, 'success': 9, 'collisions': 13}, {'tx': 5, 'success': 0, 'collisions': 5}, {'tx': 8, 'success': 1, 'collisions': 7}, {'tx': 7, 'success': 1, 'collisions': 6}, {'tx': 23, 'success': 10, 'collisions': 13}, {'tx': 5, 'success': 0, 'collisions': 5}, {'tx': 16, 'success': 7, 'collisions': 9}, {'tx': 7, 'success': 1, 'collisions': 6}, {'tx': 10, 'success': 2, 'collisions': 8}, {'tx': 13, 'success': 4, 'collisions': 9}]"
140,30,41,383,135,248,0.6475195822454308,0.3524804177545692,0.5535,"[{'tx': 17, 'success': 7, 'collisions': 10}, {'tx': 14, 'success': 5, 'collisions': 9}, {'tx': 18, 'success': 7, 'collisions': 11}, {'tx': 11, 'success': 5, 'collisions': 6}, {'tx': 24, 'success': 11, 'collisions': 13}, {'tx': 7, 'success': 1, 'collisions': 6}, {'tx': 8, 'success': 2, 'collisions': 6}, {'tx': 20, 'success': 8, 'collisions': 12}, {'tx': 5, 'success': 1, 'collisions': 4}, {'tx': 17, 'success': 7, 'collisions': 10}, {'tx': 5, 'success': 0, 'collisions': 5}, {'tx': 15, 'success': 7, 'collisions': 8}, {'tx': 5, 'success': 1, 'collisions': 4}, {'tx': 16, 'success': 9, 'collisions': 7}, {'tx': 15, 'success': 6, 'collisions': 9}, {'tx': 18, 'success': 6, 'collisions': 12}, {'tx': 21, 'success': 9, 'collisions': 12}, {'tx': 13, 'success': 3, 'collisions': 10}, {'tx': 11, 'success': 2, 'collisions': 9}, {'tx': 21, 'success': 7, 'collisions': 14}, {'tx': 5, 'success': 0, 'collisions': 5}, {'tx': 9, 'success': 3, 'collisions': 6}, {'tx': 12, 'success': 3, 'collisions': 9}, {'tx': 7, 'success': 1, 'collisions': 6}, {'tx': 12, 'success': 3, 'collisions': 9}, {'tx': 7, 'success': 2, 'collisions': 5}, {'tx': 22, 'success': 14, 'collisions': 8}, {'tx': 13, 'success': 3, 'collisions': 10}, {'tx': 9, 'success': 2, 'collisions': 7}, {'tx': 6, 'success': 0, 'collisions': 6}]"
141,30,42,388,132,256,0.6597938144329897,0.3402061855670103,0.5544,"[{'tx': 16, 'success': 7, 'collisions': 9}, {'tx': 9, 'success': 3, 'collisions': 6}, {'tx': 5, 'success': 0, 'collisions': 5}, {'tx': 19, 'success': 8, 'collisions': 11}, {'tx': 5, 'success': 0, 'collisions': 5}, {'tx': 10, 'success': 3, 'collisions': 7}, {'tx': 18, 'success': 8, 'collisions': 10}, {'tx': 5, 'success': 0, 'collisions': 5}, {'tx': 12, 'success': 4, 'collisions': 8}, {'tx': 6, 'success': 0, 'collisions': 6}, {'tx': 22, 'success': 9, 'collisions': 13}, {'tx': 5, 'success': 0, 'collisions': 5}, {'tx': 24, 'success': 9, 'collisions': 15}, {'tx': 12, 'success': 5, 'collisions': 7}, {'tx': 11, 'success': 4, 'collisions': 7}, {'tx': 14, 'success': 6, 'collisions': 8}, {'tx': 12, 'success': 4, 'collisions': 8}, {'tx': 11, 'success': 2, 'collisions': 9}, {'tx': 5, 'success': 0, 'collisions': 5}, {'tx': 23, 'success': 8, 'collisions': 15}, {'tx': 12, 'success': 4, 'collisions': 8}, {'tx': 7, 'success': 1, 'collisions': 6}, {'tx': 17, 'success': 7, 'collisions': 10}, {'tx': 20, 'success': 7, 'collisions': 13}, {'tx': 5, 'success': 0, 'collisions': 5}, {'tx': 11, 'success': 4, 'collisions': 7}, {'tx': 17, 'success': 6, 'collisions': 11}, {'tx': 18, 'success': 7, 'collisions': 11}, {'tx': 17, 'success': 7, 'collisions': 10}, {'tx': 20, 'success': 9, 'collisions': 11}]"
142,30,43,377,131,246,0.6525198938992043,0.34748010610079577,0.5633,"[{'tx': 5, 'success': 0, 'collisions': 5}, {'tx': 5, 'success': 0, 'collisions': 5}, {'tx': 15, 'success': 5, 'collisions': 10}, {'tx': 11, 'success': 3, 'collisions': 8}, {'tx': 24, 'success': 14, 'collisions': 10}, {'tx': 7, 'success': 1, 'collisions': 6}, {'tx': 13, 'success': 4, 'collisions': 9}, {'tx': 6, 'success': 1, 'collisions': 5}, {'tx': 6, 'success': 1, 'collisions': 5}, {'tx': 21, 'success': 9, 'collisions': 12}, {'tx': 12, 'success': 3, 'collisions': 9}, {'tx': 16, 'success': 6, 'collisions': 10}, {'tx': 15, 'success': 4, 'collisions': 11}, {'tx': 15, 'success': 7, 'collisions': 8}, {'tx': 19, 'success': 6, 'collisions': 13}, {'tx': 8, 'success': 1, 'collisions': 7}, {'tx': 5, 'success': 0, 'collisions': 5}, {'tx': 9, 'success': 2, 'collisions': 7}, {'tx': 9, 'success': 2, 'collisions': 7}, {'tx': 17, 'success': 5, 'collisions': 12}, {'tx': 8, 'success': 3, 'collisions': 5}, {'tx': 20, 'success': 8, 'collisions': 12}, {'tx': 23, 'success': 15, 'collisions': 8}, {'tx': 12, 'success': 3, 'collisions': 9}, {'tx': 18, 'success': 9, 'collisions': 9}, {'tx': 8, 'success': 1, 'collisions': 7}, {'tx': 11, 'success': 3, 'collisions': 8}, {'tx': 19, 'success': 8, 'collisions': 11}, {'tx': 13, 'success': 6, 'collisions': 7}, {'tx': 7, 'success': 1, 'collisions': 6}]"
143,30,44,367,131,236,0.6430517711171662,0.3569482288828338,0.5764,"[{'tx': 24, 'success': 13, 'collisions': 11}, {'tx': 6, 'success': 1, 'collisions': 5}, {'tx': 6, 'success': 1, 'collisions': 5}, {'tx': 11, 'success': 2, 'collisions': 9}, {'tx': 5, 'success': 1, 'collisions': 4}, {'tx': 4, 'success': 0, 'collisions': 4}, {'tx': 10, 'success': 2, 'collisions': 8}, {'tx': 14, 'success': 5, 'collisions': 9}, {'tx': 18, 'success': 7, 'collisions': 11}, {'tx': 20, 'success': 9, 'collisions': 11}, {'tx': 4, 'success': 0, 'collisions': 4}, {'tx': 15, 'success': 8, 'collisions': 7}, {'tx': 6, 'success': 1, 'collisions': 5}, {'tx': 14, 'success': 6, 'collisions': 8}, {'tx': 29, 'success': 15, 'collisions': 14}, {'tx': 7, 'success': 1, 'collisions': 6}, {'tx': 5, 'success': 0, 'collisions': 5}, {'tx': 9, 'success': 2, 'collisions': 7}, {'tx': 18, 'success': 8, 'collisions': 10}, {'tx': 12, 'success': 3, 'collisions': 9}, {'tx': 9, 'success': 2, 'collisions': 7}, {'tx': 18, 'success': 7, 'collisions': 11}, {'tx': 18, 'success': 7, 'collisions': 11}, {'tx': 20, 'success': 10, 'collisions': 10}, {'tx': 13, 'success': 4, 'collisions': 9}, {'tx': 8, 'success': 2, 'collisions': 6}, {'tx': 17, 'success': 7, 'collisions': 10}, {'tx': 12, 'success': 4, 'collisions': 8}, {'tx': 7, 'success': 1, 'collisions': 6}, {'tx': 8, 'success': 2, 'collisions': 6}]"
144,30,45,369,116,253,0.6856368563685636,0.3143631436314363,0.522,"[{'tx': 10, 'success': 4, 'collisions': 6}, {'tx': 20, 'success': 8, 'collisions': 12}, {'tx': 12, 'success': 4, 'collisions': 8}, {'tx': 16, 'success': 6, 'collisions': 10}, {'tx': 5, 'success': 0, 'collisions': 5}, {'tx': 6, 'success': 1, 'collisions': 5}, {'tx': 18, 'success': 7, 'collisions': 11}, {'tx': 14, 'success': 4, 'collisions': 10}, {'tx': 13, 'success': 5, 'collisions': 8}, {'tx': 26, 'success': 14, 'collisions': 12}, {'tx': 5, 'success': 0, 'collisions': 5}, {'tx': 14, 'success': 4, 'collisions': 10}, {'tx': 5, 'success': 0, 'collisions': 5}, {'tx': 17, 'success': 5, 'collisions': 12}, {'tx': 13, 'success': 4, 'collisions': 9}, {'tx': 11, 'success': 4, 'collisions': 7}, {'tx': 7, 'success': 1, 'collisions': 6}, {'tx': 10, 'success': 1, 'collisions': 9}, {'tx': 15, 'success': 4, 'collisions': 11}, {'tx': 20, 'success': 8, 'collisions': 12}, {'tx': 15, 'success': 5, 'collisions': 10}, {'tx': 17, 'success': 6, 'collisions': 11}, {'tx': 15, 'success': 6, 'collisions': 9}, {'tx': 5, 'success': 0, 'collisions': 5}, {'tx': 5, 'success': 0, 'collisions': 5}, {'tx': 5, 'success': 0, 'collisions': 5}, {'tx': 9, 'success': 2, 'collisions': 7}, {'tx': 10, 'success': 2, 'collisions': 8}, {'tx': 26, 'success': 11, 'collisions': 15}, {'tx': 5, 'success': 0, 'collisions': 5}]"
145,30,46,366,126,240,0.6557377049180327,0.3442622950819672,0.5796,"[{'tx': 6, 'success': 1, 'collisions': 5}, {'tx': 21, 'success': 9, 'collisions': 12}, {'tx': 21, 'success': 8, 'collisions': 13}, {'tx': 13, 'success': 3, 'collisions': 10}, {'tx': 5, 'success': 0, 'collisions': 5}, {'tx': 25, 'success': 14, 'collisions': 11}, {'tx': 10, 'success': 4, 'collisions': 6}, {'tx': 12, 'success': 4, 'collisions': 8}, {'tx': 15, 'success': 4, 'collisions': 11}, {'tx': 14, 'success': 8, 'collisions': 6}, {'tx': 16, 'success': 7, 'collisions': 9}, {'tx': 5, 'success': 0, 'collisions': 5}, {'tx': 10, 'success': 2, 'collisions': 8}, {'tx': 14, 'success': 4, 'collisions': 10}, {'tx': 10, 'success': 1, 'collisions': 9}, {'tx': 5, 'success': 0, 'collisions': 5}, {'tx': 17, 'success': 7, 'collisions': 10}, {'tx': 18, 'success': 7, 'collisions': 11}, {'tx': 11, 'success': 3, 'collisions': 8}, {'tx': 19, 'success': 9, 'collisions': 10}, {'tx': 7, 'success': 1, 'collisions': 6}, {'tx': 20, 'success': 9, 'collisions': 11}, {'tx': 15, 'success': 6, 'collisions': 9}, {'tx': 5, 'success': 0, 'collisions': 5}, {'tx': 5, 'success': 0, 'collisions': 5}, {'tx': 12, 'success': 3, 'collisions': 9}, {'tx': 5, 'success': 0, 'collisions': 5}, {'tx': 4, 'success': 0, 'collisions': 4}, {'tx': 22, 'success': 12, 'collisions': 10}, {'tx': 4, 'success': 0, 'collisions': 4}]"
146,30,47,340,124,216,0.6352941176470588,0.36470588235294116,0.5828,"[{'tx': 9, 'success': 2, 'collisions': 7}, {'tx': 9, 'success': 2, 'collisions': 7}, {'tx': 4, 'success': 0, 'collisions': 4}, {'tx': 17, 'success': 7, 'collisions': 10}, {'tx': 11, 'success': 3, 'collisions': 8}, {'tx': 18, 'success': 8, 'collisions': 10}, {'tx': 4, 'success': 0, 'collisions': 4}, {'tx': 15, 'success': 7, 'collisions': 8}, {'tx': 13, 'success': 4, 'collisions': 9}, {'tx': 23, 'success': 13, 'collisions': 10}, {'tx': 5, 'success': 0, 'collisions': 5}, {'tx': 20, 'success': 12, 'collisions': 8}, {'tx': 6, 'success': 1, 'collisions': 5}, {'tx': 18, 'success': 7, 'collisions': 11}, {'tx': 14, 'success': 5, 'collisions': 9}, {'tx': 15, 'success': 6, 'collisions': 9}, {'tx': 12, 'success': 5, 'collisions': 7}, {'tx': 13, 'success': 6, 'collisions': 7}, {'tx': 8, 'success': 2, 'collisions': 6}, {'tx': 10, 'success': 3, 'collisions': 7}, {'tx': 16, 'success': 6, 'collisions': 10}, {'tx': 17, 'success': 7, 'collisions': 10}, {'tx': 8, 'success': 2, 'collisions': 6}, {'tx': 5, 'success': 0, 'collisions': 5}, {'tx': 5, 'success': 0, 'collisions': 5}, {'tx': 11, 'success': 4, 'collisions': 7}, {'tx': 4, 'success': 0, 'collisions': 4}, {'tx': 6, 'success': 1, 'collisions': 5}, {'tx': 13, 'success': 7, 'collisions': 6}, {'tx': 11, 'success': 4, 'collisions': 7}]"
147,30,48,343,114,229,0.6676384839650146,0.3323615160349854,0.5472,"[{'tx': 14, 'success': 5, 'collisions': 9}, {'tx': 16, 'success': 5, 'collisions': 11}, {'tx': 7, 'success': 2, 'collisions': 5}, {'tx': 6, 'success': 1, 'collisions': 5}, {'tx': 5, 'success': 0, 'collisions': 5}, {'tx': 11, 'success': 3, 'collisions': 8}, {'tx': 8, 'success': 2, 'collisions': 6}, {'tx': 12, 'success': 4, 'collisions': 8}, {'tx': 27, 'success': 14, 'collisions': 13}, {'tx': 19, 'success': 7, 'collisions': 12}, {'tx': 14, 'success': 5, 'collisions': 9}, {'tx': 5, 'success': 0, 'collisions': 5}, {'tx': 7, 'success': 1, 'collisions': 6}, {'tx': 16, 'success': 6, 'collisions': 10}, {'tx': 7, 'success': 1, 'collisions': 6}, {'tx': 5, 'success': 0, 'collisions': 5}, {'tx': 9, 'success': 2, 'collisions': 7}, {'tx': 16, 'success': 8, 'collisions': 8}, {'tx': 5, 'success': 0, 'collisions': 5}, {'tx': 9, 'success': 3, 'collisions': 6}, {'tx': 6, 'success': 1, 'collisions': 5}, {'tx': 18, 'success': 9, 'collisions': 9}, {'tx': 15, 'success': 7, 'collisions': 8}, {'tx': 11, 'success': 4, 'collisions': 7}, {'tx': 13, 'success': 4, 'collisions': 9}, {'tx': 14, 'success': 5, 'collisions': 9}, {'tx': 8, 'success': 1, 'collisions': 7}, {'tx': 8, 'success': 2, 'collisions': 6}, {'tx': 12, 'success': 5, 'collisions': 7}, {'tx': 20, 'success': 7, 'collisions': 13}]"
148,30,49,337,116,221,0.655786350148368,0.34421364985163205,0.5684,"[{'tx': 16, 'success': 6, 'collisions': 10}, {'tx': 6, 'success': 0, 'collisions': 6}, {'tx': 15, 'success': 8, 'collisions': 7}, {'tx': 5, 'success': 0, 'collisions': 5}, {'tx': 5, 'success': 0, 'collisions': 5}, {'tx': 17, 'success': 7, 'collisions': 10}, {'tx': 11, 'success': 4, 'collisions': 7}, {'tx': 5, 'success': 0, 'collisions': 5}, {'tx': 15, 'success': 7, 'collisions': 8}, {'tx': 8, 'success': 2, 'collisions': 6}, {'tx': 22, 'success': 12, 'collisions': 10}, {'tx': 16, 'success': 6, 'collisions': 10}, {'tx': 6, 'success': 0, 'collisions': 6}, {'tx': 12, 'success': 3, 'collisions': 9}, {'tx': 5, 'success': 0, 'collisions': 5}, {'tx': 15, 'success': 7, 'collisions': 8}, {'tx': 13, 'success': 4, 'collisions': 9}, {'tx': 6, 'success': 1, 'collisions': 5}, {'tx': 9, 'success': 3, 'collisions': 6}, {'tx': 8, 'success': 1, 'collisions': 7}, {'tx': 5, 'success': 0, 'collisions': 5}, {'tx': 13, 'success': 4, 'collisions': 9}, {'tx': 8, 'success': 4, 'collisions': 4}, {'tx': 15, 'success': 4, 'collisions': 11}, {'tx': 10, 'success': 4, 'collisions': 6}, {'tx': 13, 'success': 4, 'collisions': 9}, {'tx': 23, 'success': 12, 'collisions': 11}, {'tx': 9, 'success': 1, 'collisions': 8}, {'tx': 19, 'success': 10, 'collisions': 9}, {'tx': 7, 'success': 2, 'collisions': 5}]"
149,30,50,325,117,208,0.64,0.36,0.585,"[{'tx': 4, 'success': 0, 'collisions': 4}, {'tx': 8, 'success': 1, 'collisions': 7}, {'tx': 6, 'success': 0, 'collisions': 6}, {'tx': 18, 'success': 10, 'collisions': 8}, {'tx': 30, 'success': 16, 'collisions': 14}, {'tx': 24, 'success': 10, 'collisions': 14}, {'tx': 7, 'success': 3, 'collisions': 4}, {'tx': 15, 'success': 7, 'collisions': 8}, {'tx': 17, 'success': 8, 'collisions': 9}, {'tx': 15, 'success': 8, 'collisions': 7}, {'tx': 5, 'success': 0, 'collisions': 5}, {'tx': 9, 'success': 2, 'collisions': 7}, {'tx': 12, 'success': 3, 'collisions': 9}, {'tx': 9, 'success': 3, 'collisions': 6}, {'tx': 5, 'success': 0, 'collisions': 5}, {'tx': 11, 'success': 3, 'collisions': 8}, {'tx': 24, 'success': 14, 'collisions': 10}, {'tx': 4, 'success': 0, 'collisions': 4}, {'tx': 18, 'success': 8, 'collisions': 10}, {'tx': 18, 'success': 7, 'collisions': 11}, {'tx': 4, 'success': 0, 'collisions': 4}, {'tx': 5, 'success': 0, 'collisions': 5}, {'tx': 14, 'success': 6, 'collisions': 8}, {'tx': 4, 'success': 0, 'collisions': 4}, {'tx': 4, 'success': 0, 'collisions': 4}, {'tx': 9, 'success': 4, 'collisions': 5}, {'tx': 5, 'success': 0, 'collisions': 5}, {'tx': 12, 'success': 3, 'collisions': 9}, {'tx': 5, 'success': 1, 'collisions': 4}, {'tx': 4, 'success': 0, 'collisions': 4}]"
150,30,51,314,110,204,0.6496815286624203,0.3503184713375796,0.561,"[{'tx': 11, 'success': 5, 'collisions': 6}, {'tx': 11, 'success': 4, 'collisions': 7}, {'tx': 11, 'success': 4, 'collisions': 7}, {'tx': 21, 'success': 10, 'collisions': 11}, {'tx': 4, 'success': 0, 'collisions': 4}, {'tx': 10, 'success': 3, 'collisions': 7}, {'tx': 13, 'success': 5, 'collisions': 8}, {'tx': 4, 'success': 0, 'collisions': 4}, {'tx': 10, 'success': 3, 'collisions': 7}, {'tx': 7, 'success': 3, 'collisions': 4}, {'tx': 7, 'success': 1, 'collisions': 6}, {'tx': 9, 'success': 2, 'collisions': 7}, {'tx': 9, 'success': 4, 'collisions': 5}, {'tx': 19, 'success': 8, 'collisions': 11}, {'tx': 15, 'success': 8, 'collisions': 7}, {'tx': 11, 'success': 3, 'collisions': 8}, {'tx': 4, 'success': 0, 'collisions': 4}, {'tx': 4, 'success': 0, 'collisions': 4}, {'tx': 16, 'success': 6, 'collisions': 10}, {'tx': 21, 'success': 13, 'collisions': 8}, {'tx': 12, 'success': 3, 'collisions': 9}, {'tx': 7, 'success': 1, 'collisions': 6}, {'tx': 4, 'success': 0, 'collisions': 4}, {'tx': 6, 'success': 1, 'collisions': 5}, {'tx': 13, 'success': 5, 'collisions': 8}, {'tx': 11, 'success': 4, 'collisions': 7}, {'tx': 8, 'success': 2, 'collisions': 6}, {'tx': 14, 'success': 5, 'collisions': 9}, {'tx': 11, 'success': 3, 'collisions': 8}, {'tx': 11, 'success': 4, 'collisions': 7}]"
151,30,52,320,102,218,0.68125,0.31875,0.5304,"[{'tx': 19, 'success': 7, 'collisions': 12}, {'tx': 10, 'success': 3, 'collisions': 7}, {'tx': 5, 'success': 0, 'collisions': 5}, {'tx': 6, 'success': 0, 'collisions': 6}, {'tx': 7, 'success': 1, 'collisions': 6}, {'tx': 12, 'success': 5, 'collisions': 7}, {'tx': 5, 'success': 0, 'collisions': 5}, {'tx': 7, 'success': 1, 'collisions': 6}, {'tx': 7, 'success': 1, 'collisions': 6}, {'tx': 21, 'success': 9, 'collisions': 12}, {'tx': 16, 'success': 7, 'collisions': 9}, {'tx': 10, 'success': 4, 'collisions': 6}, {'tx': 22, 'success': 13, 'collisions': 9}, {'tx': 10, 'success': 2, 'collisions': 8}, {'tx': 9, 'success': 2, 'collisions': 7}, {'tx': 18, 'success': 8, 'collisions': 10}, {'tx': 18, 'success': 5, 'collisions': 13}, {'tx': 6, 'success': 1, 'collisions': 5}, {'tx': 10, 'success': 4, 'collisions': 6}, {'tx': 11, 'success': 5, 'collisions': 6}, {'tx': 8, 'success': 1, 'collisions': 7}, {'tx': 8, 'success': 2, 'collisions': 6}, {'tx': 11, 'success': 3, 'collisions': 8}, {'tx': 6, 'success': 1, 'collisions': 5}, {'tx': 13, 'success': 3, 'collisions': 10}, {'tx': 15, 'success': 6, 'collisions': 9}, {'tx': 6, 'success': 1, 'collisions': 5}, {'tx': 11, 'success': 4, 'collisions': 7}, {'tx': 5, 'success': 1, 'collisions': 4}, {'tx': 8, 'success': 2, 'collisions': 6}]"
152,30,53,316,107,209,0.6613924050632911,0.33860759493670883,0.5671,"[{'tx': 7, 'success': 1, 'collisions': 6}, {'tx': 5, 'success': 0, 'collisions': 5}, {'tx': 12, 'success': 4, 'collisions': 8}, {'tx': 5, 'success': 0, 'collisions': 5}, {'tx': 13, 'success': 4, 'collisions': 9}, {'tx': 5, 'success': 0, 'collisions': 5}, {'tx': 17, 'success': 8, 'collisions': 9}, {'tx': 6, 'success': 0, 'collisions': 6}, {'tx': 7, 'success': 1, 'collisions': 6}, {'tx': 15, 'success': 8, 'collisions': 7}, {'tx': 13, 'success': 4, 'collisions': 9}, {'tx': 11, 'success': 3, 'collisions': 8}, {'tx': 27, 'success': 16, 'collisions': 11}, {'tx': 16, 'success': 7, 'collisions': 9}, {'tx': 15, 'success': 5, 'collisions': 10}, {'tx': 4, 'success': 0, 'collisions': 4}, {'tx': 7, 'success': 1, 'collisions': 6}, {'tx': 4, 'success': 0, 'collisions': 4}, {'tx': 4, 'success': 0, 'collisions': 4}, {'tx': 13, 'success': 6, 'collisions': 7}, {'tx': 15, 'success': 6, 'collisions': 9}, {'tx': 13, 'success': 5, 'collisions': 8}, {'tx': 8, 'success': 1, 'collisions': 7}, {'tx': 5, 'success': 0, 'collisions': 5}, {'tx': 5, 'success': 0, 'collisions': 5}, {'tx': 18, 'success': 10, 'collisions': 8}, {'tx': 5, 'success': 0, 'collisions': 5}, {'tx': 4, 'success': 0, 'collisions': 4}, {'tx': 20, 'success': 11, 'collisions': 9}, {'tx': 17, 'success': 6, 'collisions': 11}]"
153,30,54,306,96,210,0.6862745098039216,0.3137254901960784,0.5184,"[{'tx': 26, 'success': 16, 'collisions': 10}, {'tx': 6, 'success': 1, 'collisions': 5}, {'tx': 8, 'success': 2, 'collisions': 6}, {'tx': 15, 'success': 6, 'collisions': 9}, {'tx': 8, 'success': 1, 'collisions': 7}, {'tx': 10, 'success': 4, 'collisions': 6}, {'tx': 10, 'success': 3, 'collisions': 7}, {'tx': 4, 'success': 0, 'collisions': 4}, {'tx': 13, 'success': 4, 'collisions': 9}, {'tx': 12, 'success': 3, 'collisions': 9}, {'tx': 18, 'success': 6, 'collisions': 12}, {'tx': 4, 'success': 0, 'collisions': 4}, {'tx': 4, 'success': 0, 'collisions': 4}, {'tx': 23, 'success': 13, 'collisions': 10}, {'tx': 6, 'success': 1, 'collisions': 5}, {'tx': 18, 'success': 8, 'collisions': 10}, {'tx': 6, 'success': 1, 'collisions': 5}, {'tx': 18, 'success': 9, 'collisions': 9}, {'tx': 7, 'success': 1, 'collisions': 6}, {'tx': 10, 'success': 3, 'collisions': 7}, {'tx': 10, 'success': 2, 'collisions': 8}, {'tx': 10, 'success': 2, 'collisions': 8}, {'tx': 7, 'success': 1, 'collisions': 6}, {'tx': 4, 'success': 0, 'collisions': 4}, {'tx': 5, 'success': 0, 'collisions': 5}, {'tx': 8, 'success': 2, 'collisions': 6}, {'tx': 15, 'success': 5, 'collisions': 10}, {'tx': 5, 'success': 0, 'collisions': 5}, {'tx': 5, 'success': 0, 'collisions': 5}, {'tx': 11, 'success': 2, 'collisions': 9}]"
154,30,55,311,99,212,0.6816720257234726,0.3183279742765273,0.5445,"[{'tx': 5, 'success': 0, 'collisions': 5}, {'tx': 12, 'success': 4, 'collisions': 8}, {'tx': 18, 'success': 7, 'collisions': 11}, {'tx': 5, 'success': 0, 'collisions': 5}, {'tx': 4, 'success': 0, 'collisions': 4}, {'tx': 15, 'success': 7, 'collisions': 8}, {'tx': 14, 'success': 5, 'collisions': 9}, {'tx': 5, 'success': 0, 'collisions': 5}, {'tx': 5, 'success': 0, 'collisions': 5}, {'tx': 18, 'success': 8, 'collisions': 10}, {'tx': 12, 'success': 4, 'collisions': 8}, {'tx': 4, 'success': 0, 'collisions': 4}, {'tx': 13, 'success': 2, 'collisions': 11}, {'tx': 8, 'success': 1, 'collisions': 7}, {'tx': 12, 'success': 4, 'collisions': 8}, {'tx': 19, 'success': 8, 'collisions': 11}, {'tx': 9, 'success': 2, 'collisions': 7}, {'tx': 11, 'success': 5, 'collisions': 6}, {'tx': 7, 'success': 1, 'collisions': 6}, {'tx': 10, 'success': 3, 'collisions': 7}, {'tx': 7, 'success': 1, 'collisions': 6}, {'tx': 13, 'success': 5, 'collisions': 8}, {'tx': 21, 'success': 12, 'collisions': 9}, {'tx': 10, 'success': 3, 'collisions': 7}, {'tx': 4, 'success': 0, 'collisions': 4}, {'tx': 4, 'success': 0, 'collisions': 4}, {'tx': 9, 'success': 4, 'collisions': 5}, {'tx': 7, 'success': 2, 'collisions': 5}, {'tx': 13, 'success': 5, 'collisions': 8}, {'tx': 17, 'success': 6, 'collisions': 11}]"
155,30,56,302,93,209,0.6920529801324503,0.3079470198675497,0.5208,"[{'tx': 4, 'success': 0, 'collisions': 4}, {'tx': 8, 'success': 2, 'collisions': 6}, {'tx': 14, 'success': 6, 'collisions': 8}, {'tx': 4, 'success': 0, 'collisions': 4}, {'tx': 5, 'success': 1, 'collisions': 4}, {'tx': 7, 'success': 2, 'collisions': 5}, {'tx': 16, 'success': 6, 'collisions': 10}, {'tx': 7, 'success': 1, 'collisions': 6}, {'tx': 19, 'success': 7, 'collisions': 12}, {'tx': 4, 'success': 0, 'collisions': 4}, {'tx': 4, 'success': 0, 'collisions': 4}, {'tx': 5, 'success': 1, 'collisions': 4}, {'tx': 5, 'success': 0, 'collisions': 5}, {'tx': 15, 'success': 6, 'collisions': 9}, {'tx': 4, 'success': 0, 'collisions': 4}, {'tx': 16, 'success': 8, 'collisions': 8}, {'tx': 10, 'success': 3, 'collisions': 7}, {'tx': 17, 'success': 6, 'collisions': 11}, {'tx': 14, 'success': 6, 'collisions': 8}, {'tx': 10, 'success': 2, 'collisions': 8}, {'tx': 8, 'success': 1, 'collisions': 7}, {'tx': 10, 'success': 3, 'collisions': 7}, {'tx': 9, 'success': 2, 'collisions': 7}, {'tx': 17, 'success': 8, 'collisions': 9}, {'tx': 16, 'success': 7, 'collisions': 9}, {'tx': 5, 'success': 0, 'collisions': 5}, {'tx': 10, 'success': 2, 'collisions': 8}, {'tx': 15, 'success': 6, 'collisions': 9}, {'tx': 13, 'success': 4, 'collisions': 9}, {'tx': 11, 'success': 3, 'collisions': 8}]"
156,30,57,295,91,204,0.6915254237288135,0.30847457627118646,0.5187,"[{'tx': 15, 'success': 6, 'collisions': 9}, {'tx': 5, 'success': 0, 'collisions': 5}, {'tx': 12, 'success': 5, 'collisions': 7}, {'tx': 5, 'success': 0, 'collisions': 5}, {'tx': 16, 'success': 7, 'collisions': 9}, {'tx': 8, 'success': 2, 'collisions': 6}, {'tx': 4, 'success': 0, 'collisions': 4}, {'tx': 4, 'success': 0, 'collisions': 4}, {'tx': 20, 'success': 12, 'collisions': 8}, {'tx': 13, 'success': 5, 'collisions': 8}, {'tx': 9, 'success': 2, 'collisions': 7}, {'tx': 12, 'success': 4, 'collisions': 8}, {'tx': 7, 'success': 1, 'collisions': 6}, {'tx': 17, 'success': 8, 'collisions': 9}, {'tx': 10, 'success': 4, 'collisions': 6}, {'tx': 5, 'success': 0, 'collisions': 5}, {'tx': 11, 'success': 3, 'collisions': 8}, {'tx': 12, 'success': 4, 'collisions': 8}, {'tx': 8, 'success': 1, 'collisions': 7}, {'tx': 9, 'success': 2, 'collisions': 7}, {'tx': 11, 'success': 3, 'collisions': 8}, {'tx': 5, 'success': 0, 'collisions': 5}, {'tx': 8, 'success': 1, 'collisions': 7}, {'tx': 16, 'success': 8, 'collisions': 8}, {'tx': 4, 'success': 0, 'collisions': 4}, {'tx': 16, 'success': 7, 'collisions': 9}, {'tx': 12, 'success': 3, 'collisions': 9}, {'tx': 12, 'success': 3, 'collisions': 9}, {'tx': 4, 'success': 0, 'collisions': 4}, {'tx': 5, 'success': 0, 'collisions': 5}]"
157,30,58,291,95,196,0.6735395189003437,0.32646048109965636,0.551,"[{'tx': 12, 'success': 4, 'collisions': 8}, {'tx': 4, 'success': 0, 'collisions': 4}, {'tx': 11, 'success': 4, 'collisions': 7}, {'tx': 6, 'success': 0, 'collisions': 6}, {'tx': 9, 'success': 3, 'collisions': 6}, {'tx': 8, 'success': 2, 'collisions': 6}, {'tx': 9, 'success': 2, 'collisions': 7}, {'tx': 6, 'success': 1, 'collisions': 5}, {'tx': 12, 'success': 6, 'collisions': 6}, {'tx': 8, 'success': 2, 'collisions': 6}, {'tx': 16, 'success': 5, 'collisions': 11}, {'tx': 20, 'success': 12, 'collisions': 8}, {'tx': 5, 'success': 0, 'collisions': 5}, {'tx': 7, 'success': 1, 'collisions': 6}, {'tx': 14, 'success': 5, 'collisions': 9}, {'tx': 11, 'success': 4, 'collisions': 7}, {'tx': 5, 'success': 0, 'collisions': 5}, {'tx': 12, 'success': 7, 'collisions': 5}, {'tx': 13, 'success': 7, 'collisions': 6}, {'tx': 6, 'success': 1, 'collisions': 5}, {'tx': 6, 'success': 1, 'collisions': 5}, {'tx': 15, 'success': 7, 'collisions': 8}, {'tx': 8, 'success': 1, 'collisions': 7}, {'tx': 6, 'success': 1, 'collisions': 5}, {'tx': 5, 'success': 0, 'collisions': 5}, {'tx': 19, 'success': 8, 'collisions': 11}, {'tx': 13, 'success': 4, 'collisions': 9}, {'tx': 10, 'success': 3, 'collisions': 7}, {'tx': 10, 'success': 4, 'collisions': 6}, {'tx': 5, 'success': 0, 'collisions': 5}]"
158,30,59,280,94,186,0.6642857142857143,0.3357142857142857,0.5546,"[{'tx': 12, 'success': 4, 'collisions': 8}, {'tx': 10, 'success': 4, 'collisions': 6}, {'tx': 10, 'success': 4, 'collisions': 6}, {'tx': 9, 'success': 3, 'collisions': 6}, {'tx': 13, 'success': 5, 'collisions': 8}, {'tx': 9, 'success': 2, 'collisions': 7}, {'tx': 7, 'success': 1, 'collisions': 6}, {'tx': 12, 'success': 4, 'collisions': 8}, {'tx': 10, 'success': 3, 'collisions': 7}, {'tx': 12, 'success': 6, 'collisions': 6}, {'tx': 4, 'success': 0, 'collisions': 4}, {'tx': 5, 'success': 0, 'collisions': 5}, {'tx': 5, 'success': 0, 'collisions': 5}, {'tx': 4, 'success': 0, 'collisions': 4}, {'tx': 13, 'success': 7, 'collisions': 6}, {'tx': 18, 'success': 11, 'collisions': 7}, {'tx': 9, 'success': 2, 'collisions': 7}, {'tx': 4, 'success': 0, 'collisions': 4}, {'tx': 9, 'success': 4, 'collisions': 5}, {'tx': 10, 'success': 2, 'collisions': 8}, {'tx': 7, 'success': 1, 'collisions': 6}, {'tx': 18, 'success': 7, 'collisions': 11}, {'tx': 14, 'success': 6, 'collisions': 8}, {'tx': 4, 'success': 0, 'collisions': 4}, {'tx': 10, 'success': 4, 'collisions': 6}, {'tx': 4, 'success': 0, 'collisions': 4}, {'tx': 10, 'success': 3, 'collisions': 7}, {'tx': 11, 'success': 5, 'collisions': 6}, {'tx': 4, 'success': 0, 'collisions': 4}, {'tx': 13, 'success': 6, 'collisions': 7}]"
159,30,60,269,90,179,0.6654275092936803,0.3345724907063197,0.54,"[{'tx': 5, 'success': 0, 'collisions': 5}, {'tx': 10, 'success': 5, 'collisions': 5}, {'tx': 12, 'success': 3, 'collisions': 9}, {'tx': 4, 'success': 0, 'collisions': 4}, {'tx': 9, 'success': 3, 'collisions': 6}, {'tx': 5, 'success': 0, 'collisions': 5}, {'tx': 13, 'success': 4, 'collisions': 9}, {'tx': 4, 'success': 0, 'collisions': 4}, {'tx': 5, 'success': 0, 'collisions': 5}, {'tx': 8, 'success': 2, 'collisions': 6}, {'tx': 15, 'success': 7, 'collisions': 8}, {'tx': 13, 'success': 5, 'collisions': 8}, {'tx': 5, 'success': 0, 'collisions': 5}, {'tx': 5, 'success': 0, 'collisions': 5}, {'tx': 9, 'success': 3, 'collisions': 6}, {'tx': 4, 'success': 0, 'collisions': 4}, {'tx': 10, 'success': 4, 'collisions': 6}, {'tx': 5, 'success': 0, 'collisions': 5}, {'tx': 20, 'success': 11, 'collisions': 9}, {'tx': 8, 'success': 2, 'collisions': 6}, {'tx': 14, 'success': 7, 'collisions': 7}, {'tx': 18, 'success': 8, 'collisions': 10}, {'tx': 5, 'success': 0, 'collisions': 5}, {'tx': 11, 'success': 4, 'collisions': 7}, {'tx': 10, 'success': 4, 'collisions': 6}, {'tx': 5, 'success': 1, 'collisions': 4}, {'tx': 4, 'success': 0, 'collisions': 4}, {'tx': 8, 'success': 3, 'collisions': 5}, {'tx': 5, 'success': 1, 'collisions': 4}, {'tx': 20, 'success': 13, 'collisions': 7}]"
160,30,61,278,85,193,0.6942446043165468,0.3057553956834532,0.5185,"[{'tx': 9, 'success': 2, 'collisions': 7}, {'tx': 13, 'success': 5, 'collisions': 8}, {'tx': 10, 'success': 2, 'collisions': 8}, {'tx': 18, 'success': 8, 'collisions': 10}, {'tx': 4, 'success': 0, 'collisions': 4}, {'tx': 4, 'success': 0, 'collisions': 4}, {'tx': 10, 'success': 3, 'collisions': 7}, {'tx': 5, 'success': 0, 'collisions': 5}, {'tx': 7, 'success': 1, 'collisions': 6}, {'tx': 4, 'success': 0, 'collisions': 4}, {'tx': 18, 'success': 10, 'collisions': 8}, {'tx': 5, 'success': 0, 'collisions': 5}, {'tx': 6, 'success': 1, 'collisions': 5}, {'tx': 10, 'success': 3, 'collisions': 7}, {'tx': 4, 'success': 0, 'collisions': 4}, {'tx': 9, 'success': 2, 'collisions': 7}, {'tx': 4, 'success': 0, 'collisions': 4}, {'tx': 19, 'success': 7, 'collisions': 12}, {'tx': 4, 'success': 0, 'collisions': 4}, {'tx': 14, 'success': 5, 'collisions': 9}, {'tx': 14, 'success': 7, 'collisions': 7}, {'tx': 8, 'success': 1, 'collisions': 7}, {'tx': 10, 'success': 4, 'collisions': 6}, {'tx': 14, 'success': 6, 'collisions': 8}, {'tx': 10, 'success': 2, 'collisions': 8}, {'tx': 13, 'success': 7, 'collisions': 6}, {'tx': 12, 'success': 4, 'collisions': 8}, {'tx': 5, 'success': 0, 'collisions': 5}, {'tx': 6, 'success': 2, 'collisions': 4}, {'tx': 9, 'success': 3, 'collisions': 6}]"
161,30,62,273,82,191,0.6996336996336996,0.30036630036630035,0.5084,"[{'tx': 14, 'success': 5, 'collisions': 9}, {'tx': 5, 'success': 0, 'collisions': 5}, {'tx': 15, 'success': 8, 'collisions': 7}, {'tx': 13, 'success': 5, 'collisions': 8}, {'tx': 8, 'success': 2, 'collisions': 6}, {'tx': 15, 'success': 6, 'collisions': 9}, {'tx': 15, 'success': 5, 'collisions': 10}, {'tx': 4, 'success': 0, 'collisions': 4}, {'tx': 9, 'success': 2, 'collisions': 7}, {'tx': 20, 'success': 10, 'collisions': 10}, {'tx': 5, 'success': 0, 'collisions': 5}, {'tx': 11, 'success': 3, 'collisions': 8}, {'tx': 4, 'success': 0, 'collisions': 4}, {'tx': 4, 'success': 0, 'collisions': 4}, {'tx': 4, 'success': 0, 'collisions': 4}, {'tx': 15, 'success': 7, 'collisions': 8}, {'tx': 11, 'success': 3, 'collisions': 8}, {'tx': 4, 'success': 0, 'collisions': 4}, {'tx': 12, 'success': 5, 'collisions': 7}, {'tx': 5, 'success': 0, 'collisions': 5}, {'tx': 9, 'success': 2, 'collisions': 7}, {'tx': 9, 'success': 3, 'collisions': 6}, {'tx': 5, 'success': 0, 'collisions': 5}, {'tx': 14, 'success': 7, 'collisions': 7}, {'tx': 8, 'success': 1, 'collisions': 7}, {'tx': 5, 'success': 0, 'collisions': 5}, {'tx': 13, 'success': 6, 'collisions': 7}, {'tx': 4, 'success': 0, 'collisions': 4}, {'tx': 4, 'success': 0, 'collisions': 4}, {'tx': 9, 'success': 2, 'collisions': 7}]"
162,30,63,265,89,176,0.6641509433962264,0.33584905660377357,0.5607,"[{'tx': 9, 'success': 2, 'collisions': 7}, {'tx': 8, 'success': 2, 'collisions': 6}, {'tx': 12, 'success': 3, 'collisions': 9}, {'tx': 6, 'success': 1, 'collisions': 5}, {'tx': 15, 'success': 6, 'collisions': 9}, {'tx': 11, 'success': 4, 'collisions': 7}, {'tx': 9, 'success': 3, 'collisions': 6}, {'tx': 7, 'success': 3, 'collisions': 4}, {'tx': 14, 'success': 6, 'collisions': 8}, {'tx': 7, 'success': 1, 'collisions': 6}, {'tx': 10, 'success': 4, 'collisions': 6}, {'tx': 9, 'success': 3, 'collisions': 6}, {'tx': 16, 'success': 11, 'collisions': 5}, {'tx': 4, 'success': 0, 'collisions': 4}, {'tx': 4, 'success': 0, 'collisions': 4}, {'tx': 6, 'success': 1, 'collisions': 5}, {'tx': 5, 'success': 0, 'collisions': 5}, {'tx': 5, 'success': 1, 'collisions': 4}, {'tx': 8, 'success': 3, 'collisions': 5}, {'tx': 10, 'success': 4, 'collisions': 6}, {'tx': 5, 'success': 0, 'collisions': 5}, {'tx': 12, 'success': 5, 'collisions': 7}, {'tx': 14, 'success': 7, 'collisions': 7}, {'tx': 5, 'success': 0, 'collisions': 5}, {'tx': 4, 'success': 0, 'collisions': 4}, {'tx': 9, 'success': 4, 'collisions': 5}, {'tx': 11, 'success': 4, 'collisions': 7}, {'tx': 4, 'success': 0, 'collisions': 4}, {'tx': 13, 'success': 5, 'collisions': 8}, {'tx': 13, 'success': 6, 'collisions': 7}]"
163,30,64,259,85,174,0.6718146718146718,0.3281853281853282,0.544,"[{'tx': 4, 'success': 0, 'collisions': 4}, {'tx': 10, 'success': 3, 'collisions': 7}, {'tx': 4, 'success': 0, 'collisions': 4}, {'tx': 14, 'success': 5, 'collisions': 9}, {'tx': 4, 'success': 0, 'collisions': 4}, {'tx': 19, 'success': 10, 'collisions': 9}, {'tx': 4, 'success': 0, 'collisions': 4}, {'tx': 13, 'success': 6, 'collisions': 7}, {'tx': 17, 'success': 8, 'collisions': 9}, {'tx': 5, 'success': 1, 'collisions': 4}, {'tx': 8, 'success': 1, 'collisions': 7}, {'tx': 15, 'success': 6, 'collisions': 9}, {'tx': 5, 'success': 0, 'collisions': 5}, {'tx': 4, 'success': 0, 'collisions': 4}, {'tx': 4, 'success': 0, 'collisions': 4}, {'tx': 7, 'success': 2, 'collisions': 5}, {'tx': 12, 'success': 5, 'collisions': 7}, {'tx': 5, 'success': 0, 'collisions': 5}, {'tx': 12, 'success': 5, 'collisions': 7}, {'tx': 12, 'success': 6, 'collisions': 6}, {'tx': 9, 'success': 4, 'collisions': 5}, {'tx': 7, 'success': 1, 'collisions': 6}, {'tx': 10, 'success': 4, 'collisions': 6}, {'tx': 9, 'success': 3, 'collisions': 6}, {'tx': 4, 'success': 0, 'collisions': 4}, {'tx': 5, 'success': 0, 'collisions': 5}, {'tx': 16, 'success': 10, 'collisions': 6}, {'tx': 4, 'success': 0, 'collisions': 4}, {'tx': 13, 'success': 5, 'collisions': 8}, {'tx': 4, 'success': 0, 'collisions': 4}]"
164,30,65,267,86,181,0.6779026217228464,0.32209737827715357,0.559,"[{'tx': 10, 'success': 3, 'collisions': 7}, {'tx': 9, 'success': 3, 'collisions': 6}, {'tx': 13, 'success': 5, 'collisions': 8}, {'tx': 6, 'success': 1, 'collisions': 5}, {'tx': 4, 'success': 0, 'collisions': 4}, {'tx': 4, 'success': 0, 'collisions': 4}, {'tx': 10, 'success': 3, 'collisions': 7}, {'tx': 5, 'success': 0, 'collisions': 5}, {'tx': 10, 'success': 3, 'collisions': 7}, {'tx': 11, 'success': 4, 'collisions': 7}, {'tx': 12, 'success': 5, 'collisions': 7}, {'tx': 4, 'success': 0, 'collisions': 4}, {'tx': 4, 'success': 0, 'collisions': 4}, {'tx': 7, 'success': 1, 'collisions': 6}, {'tx': 4, 'success': 0, 'collisions': 4}, {'tx': 10, 'success': 4, 'collisions': 6}, {'tx': 12, 'success': 5, 'collisions': 7}, {'tx': 12, 'success': 6, 'collisions': 6}, {'tx': 9, 'success': 2, 'collisions': 7}, {'tx': 15, 'success': 9, 'collisions': 6}, {'tx': 13, 'success': 4, 'collisions': 9}, {'tx': 9, 'success': 2, 'collisions': 7}, {'tx': 9, 'success': 4, 'collisions': 5}, {'tx': 9, 'success': 3, 'collisions': 6}, {'tx': 16, 'success': 8, 'collisions': 8}, {'tx': 8, 'success': 2, 'collisions': 6}, {'tx': 7, 'success': 1, 'collisions': 6}, {'tx': 8, 'success': 2, 'collisions': 6}, {'tx': 4, 'success': 0, 'collisions': 4}, {'tx': 13, 'success': 6, 'collisions': 7}]"
165,30,66,253,81,172,0.6798418972332015,0.3201581027667984,0.5346,"[{'tx': 4, 'success': 1, 'collisions': 3}, {'tx': 9, 'success': 4, 'collisions': 5}, {'tx': 17, 'success': 8, 'collisions': 9}, {'tx': 10, 'success': 2, 'collisions': 8}, {'tx': 5, 'success': 0, 'collisions': 5}, {'tx': 8, 'success': 2, 'collisions': 6}, {'tx': 8, 'success': 3, 'collisions': 5}, {'tx': 8, 'success': 1, 'collisions': 7}, {'tx': 11, 'success': 3, 'collisions': 8}, {'tx': 9, 'success': 2, 'collisions': 7}, {'tx': 6, 'success': 1, 'collisions': 5}, {'tx': 6, 'success': 1, 'collisions': 5}, {'tx': 10, 'success': 6, 'collisions': 4}, {'tx': 15, 'success': 8, 'collisions': 7}, {'tx': 6, 'success': 1, 'collisions': 5}, {'tx': 4, 'success': 0, 'collisions': 4}, {'tx': 4, 'success': 0, 'collisions': 4}, {'tx': 4, 'success': 0, 'collisions': 4}, {'tx': 6, 'success': 1, 'collisions': 5}, {'tx': 5, 'success': 0, 'collisions': 5}, {'tx': 14, 'success': 8, 'collisions': 6}, {'tx': 12, 'success': 5, 'collisions': 7}, {'tx': 5, 'success': 0, 'collisions': 5}, {'tx': 13, 'success': 5, 'collisions': 8}, {'tx': 10, 'success': 4, 'collisions': 6}, {'tx': 7, 'success': 1, 'collisions': 6}, {'tx': 7, 'success': 2, 'collisions': 5}, {'tx': 9, 'success': 3, 'collisions': 6}, {'tx': 10, 'success': 3, 'collisions': 7}, {'tx': 11, 'success': 6, 'collisions': 5}]"
166,30,67,261,80,181,0.6934865900383141,0.3065134099616858,0.536,"[{'tx': 4, 'success': 0, 'collisions': 4}, {'tx': 7, 'success': 1, 'collisions': 6}, {'tx': 9, 'success': 2, 'collisions': 7}, {'tx': 9, 'success': 3, 'collisions': 6}, {'tx': 4, 'success': 0, 'collisions': 4}, {'tx': 9, 'success': 2, 'collisions': 7}, {'tx': 8, 'success': 2, 'collisions': 6}, {'tx': 10, 'success': 2, 'collisions': 8}, {'tx': 12, 'success': 3, 'collisions': 9}, {'tx': 15, 'success': 5, 'collisions': 10}, {'tx': 9, 'success': 3, 'collisions': 6}, {'tx': 12, 'success': 5, 'collisions': 7}, {'tx': 4, 'success': 0, 'collisions': 4}, {'tx': 19, 'success': 10, 'collisions': 9}, {'tx': 4, 'success': 0, 'collisions': 4}, {'tx': 9, 'success': 3, 'collisions': 6}, {'tx': 9, 'success': 2, 'collisions': 7}, {'tx': 10, 'success': 4, 'collisions': 6}, {'tx': 8, 'success': 2, 'collisions': 6}, {'tx': 9, 'success': 2, 'collisions': 7}, {'tx': 4, 'success': 0, 'collisions': 4}, {'tx': 11, 'success': 5, 'collisions': 6}, {'tx': 5, 'success': 1, 'collisions': 4}, {'tx': 7, 'success': 3, 'collisions': 4}, {'tx': 5, 'success': 1, 'collisions': 4}, {'tx': 6, 'success': 1, 'collisions': 5}, {'tx': 12, 'success': 5, 'collisions': 7}, {'tx': 8, 'success': 2, 'collisions': 6}, {'tx': 15, 'success': 8, 'collisions': 7}, {'tx': 8, 'success': 3, 'collisions': 5}]"
167,30,68,248,75,173,0.6975806451612904,0.3024193548387097,0.51,"[{'tx': 5, 'success': 0, 'collisions': 5}, {'tx': 4, 'success': 0, 'collisions': 4}, {'tx': 10, 'success': 3, 'collisions': 7}, {'tx': 10, 'success': 5, 'collisions': 5}, {'tx': 10, 'success': 4, 'collisions': 6}, {'tx': 5, 'success': 0, 'collisions': 5}, {'tx': 4, 'success': 0, 'collisions': 4}, {'tx': 5, 'success': 0, 'collisions': 5}, {'tx': 11, 'success': 4, 'collisions': 7}, {'tx': 9, 'success': 4, 'collisions': 5}, {'tx': 11, 'success': 5, 'collisions': 6}, {'tx': 10, 'success': 4, 'collisions': 6}, {'tx': 9, 'success': 3, 'collisions': 6}, {'tx': 5, 'success': 0, 'collisions': 5}, {'tx': 8, 'success': 4, 'collisions': 4}, {'tx': 9, 'success': 3, 'collisions': 6}, {'tx': 6, 'success': 1, 'collisions': 5}, {'tx': 5, 'success': 1, 'collisions': 4}, {'tx': 11, 'success': 4, 'collisions': 7}, {'tx': 9, 'success': 2, 'collisions': 7}, {'tx': 4, 'success': 0, 'collisions': 4}, {'tx': 6, 'success': 1, 'collisions': 5}, {'tx': 13, 'success': 5, 'collisions': 8}, {'tx': 10, 'success': 3, 'collisions': 7}, {'tx': 13, 'success': 5, 'collisions': 8}, {'tx': 6, 'success': 1, 'collisions': 5}, {'tx': 10, 'success': 3, 'collisions': 7}, {'tx': 8, 'success': 2, 'collisions': 6}, {'tx': 7, 'success': 2, 'collisions': 5}, {'tx': 15, 'success': 6, 'collisions': 9}]"
168,30,69,249,75,174,0.6987951807228916,0.30120481927710846,0.5175,"[{'tx': 10, 'success': 5, 'collisions': 5}, {'tx': 6, 'success': 1, 'collisions': 5}, {'tx': 4, 'success': 0, 'collisions': 4}, {'tx': 12, 'success': 4, 'collisions': 8}, {'tx': 7, 'success': 1, 'collisions': 6}, {'tx': 8, 'success': 2, 'collisions': 6}, {'tx': 7, 'success': 1, 'collisions': 6}, {'tx': 5, 'success': 1, 'collisions': 4}, {'tx': 14, 'success': 6, 'collisions': 8}, {'tx': 10, 'success': 5, 'collisions': 5}, {'tx': 11, 'success': 4, 'collisions': 7}, {'tx': 13, 'success': 7, 'collisions': 6}, {'tx': 8, 'success': 4, 'collisions': 4}, {'tx': 4, 'success': 0, 'collisions': 4}, {'tx': 4, 'success': 0, 'collisions': 4}, {'tx': 12, 'success': 4, 'collisions': 8}, {'tx': 6, 'success': 1, 'collisions': 5}, {'tx': 4, 'success': 0, 'collisions': 4}, {'tx': 9, 'success': 2, 'collisions': 7}, {'tx': 12, 'success': 4, 'collisions': 8}, {'tx': 7, 'success': 2, 'collisions': 5}, {'tx': 4, 'success': 0, 'collisions': 4}, {'tx': 8, 'success': 1, 'collisions': 7}, {'tx': 6, 'success': 1, 'collisions': 5}, {'tx': 9, 'success': 3, 'collisions': 6}, {'tx': 5, 'success': 0, 'collisions': 5}, {'tx': 15, 'success': 8, 'collisions': 7}, {'tx': 12, 'success': 4, 'collisions': 8}, {'tx': 12, 'success': 4, 'collisions': 8}, {'tx': 5, 'success': 0, 'collisions': 5}]"
169,30,70,246,76,170,0.6910569105691057,0.3089430894308943,0.532,"[{'tx': 13, 'success': 6, 'collisions': 7}, {'tx': 15, 'success': 6, 'collisions': 9}, {'tx': 8, 'success': 2, 'collisions': 6}, {'tx': 4, 'success': 0, 'collisions': 4}, {'tx': 11, 'success': 3, 'collisions': 8}, {'tx': 4, 'success': 0, 'collisions': 4}, {'tx': 4, 'success': 0, 'collisions': 4}, {'tx': 9, 'success': 2, 'collisions': 7}, {'tx': 8, 'success': 2, 'collisions': 6}, {'tx': 10, 'success': 5, 'collisions': 5}, {'tx': 4, 'success': 0, 'collisions': 4}, {'tx': 9, 'success': 2, 'collisions': 7}, {'tx': 4, 'success': 0, 'collisions': 4}, {'tx': 8, 'success': 2, 'collisions': 6}, {'tx': 9, 'success': 4, 'collisions': 5}, {'tx': 5, 'success': 1, 'collisions': 4}, {'tx': 11, 'success': 5, 'collisions': 6}, {'tx': 4, 'success': 0, 'collisions': 4}, {'tx': 9, 'success': 3, 'collisions': 6}, {'tx': 10, 'success': 4, 'collisions': 6}, {'tx': 10, 'success': 3, 'collisions': 7}, {'tx': 10, 'success': 3, 'collisions': 7}, {'tx': 12, 'success': 5, 'collisions': 7}, {'tx': 15, 'success': 8, 'collisions': 7}, {'tx': 11, 'success': 6, 'collisions': 5}, {'tx': 9, 'success': 3, 'collisions': 6}, {'tx': 7, 'success': 1, 'collisions': 6}, {'tx': 4, 'success': 0, 'collisions': 4}, {'tx': 4, 'success': 0, 'collisions': 4}, {'tx': 5, 'success': 0, 'collisions': 5}]"
170,30,71,245,72,173,0.7061224489795919,0.2938775510204082,0.5112,"[{'tx': 6, 'success': 2, 'collisions': 4}, {'tx': 4, 'success': 0, 'collisions': 4}, {'tx': 7, 'success': 0, 'collisions': 7}, {'tx': 4, 'success': 0, 'collisions': 4}, {'tx': 4, 'success': 0, 'collisions': 4}, {'tx': 14, 'success': 7, 'collisions': 7}, {'tx': 11, 'success': 3, 'collisions': 8}, {'tx': 4, 'success': 0, 'collisions': 4}, {'tx': 13, 'success': 7, 'collisions': 6}, {'tx': 7, 'success': 1, 'collisions': 6}, {'tx': 9, 'success': 3, 'collisions': 6}, {'tx': 8, 'success': 3, 'collisions': 5}, {'tx': 12, 'success': 3, 'collisions': 9}, {'tx': 4, 'success': 0, 'collisions': 4}, {'tx': 4, 'success': 0, 'collisions': 4}, {'tx': 14, 'success': 6, 'collisions': 8}, {'tx': 11, 'success': 4, 'collisions': 7}, {'tx': 7, 'success': 2, 'collisions': 5}, {'tx': 17, 'success': 7, 'collisions': 10}, {'tx': 14, 'success': 8, 'collisions': 6}, {'tx': 6, 'success': 1, 'collisions': 5}, {'tx': 4, 'success': 0, 'collisions': 4}, {'tx': 8, 'success': 2, 'collisions': 6}, {'tx': 8, 'success': 2, 'collisions': 6}, {'tx': 6, 'success': 1, 'collisions': 5}, {'tx': 5, 'success': 0, 'collisions': 5}, {'tx': 5, 'success': 1, 'collisions': 4}, {'tx': 9, 'success': 2, 'collisions': 7}, {'tx': 7, 'success': 1, 'collisions': 6}, {'tx': 13, 'success': 6, 'collisions': 7}]"
171,30,72,238,68,170,0.7142857142857143,0.2857142857142857,0.4896,"[{'tx': 11, 'success': 4, 'collisions': 7}, {'tx': 5, 'success': 0, 'collisions': 5}, {'tx': 4, 'success': 0, 'collisions': 4}, {'tx': 4, 'success': 0, 'collisions': 4}, {'tx': 8, 'success': 3, 'collisions': 5}, {'tx': 5, 'success': 0, 'collisions': 5}, {'tx': 11, 'success': 5, 'collisions': 6}, {'tx': 8, 'success': 2, 'collisions': 6}, {'tx': 6, 'success': 1, 'collisions': 5}, {'tx': 9, 'success': 3, 'collisions': 6}, {'tx': 15, 'success': 7, 'collisions': 8}, {'tx': 4, 'success': 0, 'collisions': 4}, {'tx': 11, 'success': 4, 'collisions': 7}, {'tx': 17, 'success': 6, 'collisions': 11}, {'tx': 4, 'success': 0, 'collisions': 4}, {'tx': 12, 'success': 4, 'collisions': 8}, {'tx': 5, 'success': 1, 'collisions': 4}, {'tx': 6, 'success': 1, 'collisions': 5}, {'tx': 4, 'success': 0, 'collisions': 4}, {'tx': 14, 'success': 7, 'collisions': 7}, {'tx': 14, 'success': 6, 'collisions': 8}, {'tx': 12, 'success': 6, 'collisions': 6}, {'tx': 7, 'success': 2, 'collisions': 5}, {'tx': 5, 'success': 0, 'collisions': 5}, {'tx': 6, 'success': 1, 'collisions': 5}, {'tx': 7, 'success': 2, 'collisions': 5}, {'tx': 7, 'success': 1, 'collisions': 6}, {'tx': 5, 'success': 0, 'collisions': 5}, {'tx': 8, 'success': 2, 'collisions': 6}, {'tx': 4, 'success': 0, 'collisions': 4}]"
172,30,73,245,75,170,0.6938775510204082,0.30612244897959184,0.5475,"[{'tx': 10, 'success': 4, 'collisions': 6}, {'tx': 4, 'success': 0, 'collisions': 4}, {'tx': 4, 'success': 0, 'collisions': 4}, {'tx': 5, 'success': 1, 'collisions': 4}, {'tx': 4, 'success': 0, 'collisions': 4}, {'tx': 12, 'success': 3, 'collisions': 9}, {'tx': 9, 'success': 4, 'collisions': 5}, {'tx': 5, 'success': 1, 'collisions': 4}, {'tx': 7, 'success': 1, 'collisions': 6}, {'tx': 10, 'success': 3, 'collisions': 7}, {'tx': 8, 'success': 4, 'collisions': 4}, {'tx': 4, 'success': 0, 'collisions': 4}, {'tx': 10, 'success': 3, 'collisions': 7}, {'tx': 17, 'success': 9, 'collisions': 8}, {'tx': 10, 'success': 2, 'collisions': 8}, {'tx': 4, 'success': 0, 'collisions': 4}, {'tx': 7, 'success': 2, 'collisions': 5}, {'tx': 4, 'success': 0, 'collisions': 4}, {'tx': 12, 'success': 6, 'collisions': 6}, {'tx': 8, 'success': 2, 'collisions': 6}, {'tx': 11, 'success': 4, 'collisions': 7}, {'tx': 4, 'success': 0, 'collisions': 4}, {'tx': 8, 'success': 2, 'collisions': 6}, {'tx': 14, 'success': 5, 'collisions': 9}, {'tx': 4, 'success': 0, 'collisions': 4}, {'tx': 7, 'success': 1, 'collisions': 6}, {'tx': 12, 'success': 6, 'collisions': 6}, {'tx': 7, 'success': 1, 'collisions': 6}, {'tx': 8, 'success': 3, 'collisions': 5}, {'tx': 16, 'success': 8, 'collisions': 8}]"
173,30,74,242,73,169,0.6983471074380165,0.30165289256198347,0.5402,"[{'tx': 14, 'success': 5, 'collisions': 9}, {'tx': 5, 'success': 0, 'collisions': 5}, {'tx': 4, 'success': 0, 'collisions': 4}, {'tx': 7, 'success': 1, 'collisions': 6}, {'tx': 5, 'success': 1, 'collisions': 4}, {'tx': 10, 'success': 4, 'collisions': 6}, {'tx': 13, 'success': 5, 'collisions': 8}, {'tx': 4, 'success': 0, 'collisions': 4}, {'tx': 9, 'success': 3, 'collisions': 6}, {'tx': 11, 'success': 5, 'collisions': 6}, {'tx': 17, 'success': 8, 'collisions': 9}, {'tx': 14, 'success': 7, 'collisions': 7}, {'tx': 15, 'success': 6, 'collisions': 9}, {'tx': 4, 'success': 0, 'collisions': 4}, {'tx': 12, 'success': 4, 'collisions': 8}, {'tx': 12, 'success': 5, 'collisions': 7}, {'tx': 4, 'success': 0, 'collisions': 4}, {'tx': 9, 'success': 2, 'collisions': 7}, {'tx': 3, 'success': 0, 'collisions': 3}, {'tx': 8, 'success': 2, 'collisions': 6}, {'tx': 8, 'success': 3, 'collisions': 5}, {'tx': 11, 'success': 5, 'collisions': 6}, {'tx': 5, 'success': 1, 'collisions': 4}, {'tx': 4, 'success': 1, 'collisions': 3}, {'tx': 4, 'success': 0, 'collisions': 4}, {'tx': 10, 'success': 3, 'collisions': 7}, {'tx': 4, 'success': 0, 'collisions': 4}, {'tx': 7, 'success': 1, 'collisions': 6}, {'tx': 5, 'success': 1, 'collisions': 4}, {'tx': 4, 'success': 0, 'collisions': 4}]"
174,30,75,242,60,182,0.7520661157024794,0.24793388429752067,0.45,"[{'tx': 4, 'success': 0, 'collisions': 4}, {'tx': 8, 'success': 1, 'collisions': 7}, {'tx': 5, 'success': 0, 'collisions': 5}, {'tx': 12, 'success': 3, 'collisions': 9}, {'tx': 5, 'success': 1, 'collisions': 4}, {'tx': 9, 'success': 2, 'collisions': 7}, {'tx': 4, 'success': 0, 'collisions': 4}, {'tx': 13, 'success': 7, 'collisions': 6}, {'tx': 13, 'success': 3, 'collisions': 10}, {'tx': 8, 'success': 2, 'collisions': 6}, {'tx': 8, 'success': 2, 'collisions': 6}, {'tx': 12, 'success': 5, 'collisions': 7}, {'tx': 5, 'success': 0, 'collisions': 5}, {'tx': 13, 'success': 6, 'collisions': 7}, {'tx': 13, 'success': 4, 'collisions': 9}, {'tx': 4, 'success': 0, 'collisions': 4}, {'tx': 4, 'success': 0, 'collisions': 4}, {'tx': 5, 'success': 0, 'collisions': 5}, {'tx': 4, 'success': 0, 'collisions': 4}, {'tx': 9, 'success': 3, 'collisions': 6}, {'tx': 6, 'success': 1, 'collisions': 5}, {'tx': 12, 'success': 5, 'collisions': 7}, {'tx': 15, 'success': 6, 'collisions': 9}, {'tx': 7, 'success': 1, 'collisions': 6}, {'tx': 8, 'success': 2, 'collisions': 6}, {'tx': 4, 'success': 0, 'collisions': 4}, {'tx': 8, 'success': 1, 'collisions': 7}, {'tx': 11, 'success': 2, 'collisions': 9}, {'tx': 4, 'success': 0, 'collisions': 4}, {'tx': 9, 'success': 3, 'collisions': 6}]"
175,30,76,230,65,165,0.717391304347826,0.2826086956521739,0.494,"[{'tx': 11, 'success': 5, 'collisions': 6}, {'tx': 7, 'success': 1, 'collisions': 6}, {'tx': 14, 'success': 6, 'collisions': 8}, {'tx': 9, 'success': 3, 'collisions': 6}, {'tx': 12, 'success': 4, 'collisions': 8}, {'tx': 12, 'success': 5, 'collisions': 7}, {'tx': 13, 'success': 6, 'collisions': 7}, {'tx': 4, 'success': 0, 'collisions': 4}, {'tx': 15, 'success': 6, 'collisions': 9}, {'tx': 4, 'success': 0, 'collisions': 4}, {'tx': 8, 'success': 1, 'collisions': 7}, {'tx': 4, 'success': 0, 'collisions': 4}, {'tx': 8, 'success': 3, 'collisions': 5}, {'tx': 4, 'success': 0, 'collisions': 4}, {'tx': 8, 'success': 4, 'collisions': 4}, {'tx': 9, 'success': 3, 'collisions': 6}, {'tx': 3, 'success': 0, 'collisions': 3}, {'tx': 9, 'success': 2, 'collisions': 7}, {'tx': 8, 'success': 2, 'collisions': 6}, {'tx': 8, 'success': 2, 'collisions': 6}, {'tx': 4, 'success': 0, 'collisions': 4}, {'tx': 4, 'success': 0, 'collisions': 4}, {'tx': 6, 'success': 1, 'collisions': 5}, {'tx': 3, 'success': 0, 'collisions': 3}, {'tx': 7, 'success': 1, 'collisions': 6}, {'tx': 4, 'success': 0, 'collisions': 4}, {'tx': 4, 'success': 0, 'collisions': 4}, {'tx': 12, 'success': 4, 'collisions': 8}, {'tx': 10, 'success': 4, 'collisions': 6}, {'tx': 6, 'success': 2, 'collisions': 4}]"
176,30,77,228,71,157,0.6885964912280702,0.31140350877192985,0.5467,"[{'tx': 5, 'success': 0, 'collisions': 5}, {'tx': 7, 'success': 1, 'collisions': 6}, {'tx': 4, 'success': 0, 'collisions': 4}, {'tx': 5, 'success': 1, 'collisions': 4}, {'tx': 12, 'success': 5, 'collisions': 7}, {'tx': 5, 'success': 1, 'collisions': 4}, {'tx': 5, 'success': 0, 'collisions': 5}, {'tx': 7, 'success': 2, 'collisions': 5}, {'tx': 3, 'success': 0, 'collisions': 3}, {'tx': 4, 'success': 0, 'collisions': 4}, {'tx': 6, 'success': 1, 'collisions': 5}, {'tx': 6, 'success': 3, 'collisions': 3}, {'tx': 16, 'success': 5, 'collisions': 11}, {'tx': 11, 'success': 3, 'collisions': 8}, {'tx': 7, 'success': 1, 'collisions': 6}, {'tx': 5, 'success': 1, 'collisions': 4}, {'tx': 5, 'success': 1, 'collisions': 4}, {'tx': 10, 'success': 4, 'collisions': 6}, {'tx': 4, 'success': 0, 'collisions': 4}, {'tx': 4, 'success': 0, 'collisions': 4}, {'tx': 12, 'success': 5, 'collisions': 7}, {'tx': 7, 'success': 2, 'collisions': 5}, {'tx': 7, 'success': 3, 'collisions': 4}, {'tx': 11, 'success': 5, 'collisions': 6}, {'tx': 8, 'success': 3, 'collisions': 5}, {'tx': 12, 'success': 7, 'collisions': 5}, {'tx': 12, 'success': 5, 'collisions': 7}, {'tx': 5, 'success': 0, 'collisions': 5}, {'tx': 5, 'success': 1, 'collisions': 4}, {'tx': 18, 'success': 11, 'collisions': 7}]"
177,30,78,225,69,156,0.6933333333333334,0.30666666666666664,0.5382,"[{'tx': 5, 'success': 1, 'collisions': 4}, {'tx': 4, 'success': 1, 'collisions': 3}, {'tx': 5, 'success': 0, 'collisions': 5}, {'tx': 18, 'success': 9, 'collisions': 9}, {'tx': 6, 'success': 1, 'collisions': 5}, {'tx': 11, 'success': 5, 'collisions': 6}, {'tx': 7, 'success': 1, 'collisions': 6}, {'tx': 7, 'success': 2, 'collisions': 5}, {'tx': 7, 'success': 3, 'collisions': 4}, {'tx': 5, 'success': 1, 'collisions': 4}, {'tx': 4, 'success': 1, 'collisions': 3}, {'tx': 10, 'success': 5, 'collisions': 5}, {'tx': 4, 'success': 0, 'collisions': 4}, {'tx': 11, 'success': 5, 'collisions': 6}, {'tx': 8, 'success': 2, 'collisions': 6}, {'tx': 5, 'success': 1, 'collisions': 4}, {'tx': 14, 'success': 6, 'collisions': 8}, {'tx': 5, 'success': 1, 'collisions': 4}, {'tx': 12, 'success': 6, 'collisions': 6}, {'tx': 8, 'success': 2, 'collisions': 6}, {'tx': 4, 'success': 0, 'collisions': 4}, {'tx': 7, 'success': 2, 'collisions': 5}, {'tx': 10, 'success': 4, 'collisions': 6}, {'tx': 4, 'success': 0, 'collisions': 4}, {'tx': 6, 'success': 1, 'collisions': 5}, {'tx': 7, 'success': 2, 'collisions': 5}, {'tx': 6, 'success': 1, 'collisions': 5}, {'tx': 8, 'success': 1, 'collisions': 7}, {'tx': 4, 'success': 0, 'collisions': 4}, {'tx': 13, 'success': 5, 'collisions': 8}]"
178,30,79,229,64,165,0.7205240174672489,0.2794759825327511,0.5056,"[{'tx': 4, 'success': 0, 'collisions': 4}, {'tx': 8, 'success': 1, 'collisions': 7}, {'tx': 4, 'success': 0, 'collisions': 4}, {'tx': 7, 'success': 1, 'collisions': 6}, {'tx': 5, 'success': 0, 'collisions': 5}, {'tx': 9, 'success': 2, 'collisions': 7}, {'tx': 6, 'success': 1, 'collisions': 5}, {'tx': 12, 'success': 4, 'collisions': 8}, {'tx': 7, 'success': 1, 'collisions': 6}, {'tx': 10, 'success': 3, 'collisions': 7}, {'tx': 4, 'success': 0, 'collisions': 4}, {'tx': 9, 'success': 3, 'collisions': 6}, {'tx': 7, 'success': 3, 'collisions': 4}, {'tx': 4, 'success': 0, 'collisions': 4}, {'tx': 14, 'success': 6, 'collisions': 8}, {'tx': 4, 'success': 0, 'collisions': 4}, {'tx': 15, 'success': 9, 'collisions': 6}, {'tx': 11, 'success': 5, 'collisions': 6}, {'tx': 12, 'success': 4, 'collisions': 8}, {'tx': 11, 'success': 4, 'collisions': 7}, {'tx': 5, 'success': 1, 'collisions': 4}, {'tx': 4, 'success': 0, 'collisions': 4}, {'tx': 6, 'success': 1, 'collisions': 5}, {'tx': 8, 'success': 2, 'collisions': 6}, {'tx': 5, 'success': 0, 'collisions': 5}, {'tx': 4, 'success': 0, 'collisions': 4}, {'tx': 7, 'success': 2, 'collisions': 5}, {'tx': 11, 'success': 6, 'collisions': 5}, {'tx': 4, 'success': 0, 'collisions': 4}, {'tx': 12, 'success': 5, 'collisions': 7}]"
179,30,80,226,60,166,0.7345132743362832,0.26548672566371684,0.48,"[{'tx': 10, 'success': 5, 'collisions': 5}, {'tx': 10, 'success': 3, 'collisions': 7}, {'tx': 10, 'success': 3, 'collisions': 7}, {'tx': 10, 'success': 3, 'collisions': 7}, {'tx': 4, 'success': 0, 'collisions': 4}, {'tx': 9, 'success': 3, 'collisions': 6}, {'tx': 10, 'success': 3, 'collisions': 7}, {'tx': 5, 'success': 1, 'collisions': 4}, {'tx': 5, 'success': 1, 'collisions': 4}, {'tx': 12, 'success': 5, 'collisions': 7}, {'tx': 11, 'success': 4, 'collisions': 7}, {'tx': 6, 'success': 1, 'collisions': 5}, {'tx': 9, 'success': 3, 'collisions': 6}, {'tx': 9, 'success': 4, 'collisions': 5}, {'tx': 11, 'success': 4, 'collisions': 7}, {'tx': 8, 'success': 2, 'collisions': 6}, {'tx': 7, 'success': 1, 'collisions': 6}, {'tx': 13, 'success': 4, 'collisions': 9}, {'tx': 7, 'success': 1, 'collisions': 6}, {'tx': 4, 'success': 0, 'collisions': 4}, {'tx': 4, 'success': 0, 'collisions': 4}, {'tx': 9, 'success': 3, 'collisions': 6}, {'tx': 4, 'success': 0, 'collisions': 4}, {'tx': 8, 'success': 3, 'collisions': 5}, {'tx': 4, 'success': 0, 'collisions': 4}, {'tx': 3, 'success': 0, 'collisions': 3}, {'tx': 4, 'success': 0, 'collisions': 4}, {'tx': 8, 'success': 1, 'collisions': 7}, {'tx': 4, 'success': 0, 'collisions': 4}, {'tx': 8, 'success': 2, 'collisions': 6}]"
180,30,81,220,67,153,0.6954545454545454,0.30454545454545456,0.5427,"[{'tx': 9, 'success': 4, 'collisions': 5}, {'tx': 13, 'success': 5, 'collisions': 8}, {'tx': 11, 'success': 4, 'collisions': 7}, {'tx': 10, 'success': 4, 'collisions': 6}, {'tx': 4, 'success': 0, 'collisions': 4}, {'tx': 4, 'success': 0, 'collisions': 4}, {'tx': 7, 'success': 3, 'collisions': 4}, {'tx': 9, 'success': 3, 'collisions': 6}, {'tx': 5, 'success': 1, 'collisions': 4}, {'tx': 11, 'success': 5, 'collisions': 6}, {'tx': 6, 'success': 1, 'collisions': 5}, {'tx': 5, 'success': 1, 'collisions': 4}, {'tx': 6, 'success': 2, 'collisions': 4}, {'tx': 8, 'success': 2, 'collisions': 6}, {'tx': 8, 'success': 3, 'collisions': 5}, {'tx': 11, 'success': 5, 'collisions': 6}, {'tx': 4, 'success': 0, 'collisions': 4}, {'tx': 5, 'success': 2, 'collisions': 3}, {'tx': 3, 'success': 0, 'collisions': 3}, {'tx': 7, 'success': 2, 'collisions': 5}, {'tx': 4, 'success': 0, 'collisions': 4}, {'tx': 5, 'success': 0, 'collisions': 5}, {'tx': 6, 'success': 1, 'collisions': 5}, {'tx': 7, 'success': 1, 'collisions': 6}, {'tx': 12, 'success': 6, 'collisions': 6}, {'tx': 14, 'success': 6, 'collisions': 8}, {'tx': 8, 'success': 3, 'collisions': 5}, {'tx': 7, 'success': 1, 'collisions': 6}, {'tx': 6, 'success': 1, 'collisions': 5}, {'tx': 5, 'success': 1, 'collisions': 4}]"
181,30,82,217,63,154,0.7096774193548387,0.2903225806451613,0.5166,"[{'tx': 6, 'success': 2, 'collisions': 4}, {'tx': 4, 'success': 0, 'collisions': 4}, {'tx': 12, 'success': 6, 'collisions': 6}, {'tx': 8, 'success': 2, 'collisions': 6}, {'tx': 10, 'success': 3, 'collisions': 7}, {'tx': 6, 'success': 3, 'collisions': 3}, {'tx': 4, 'success': 0, 'collisions': 4}, {'tx': 9, 'success': 2, 'collisions': 7}, {'tx': 14, 'success': 7, 'collisions': 7}, {'tx': 13, 'success': 5, 'collisions': 8}, {'tx': 8, 'success': 2, 'collisions': 6}, {'tx': 4, 'success': 0, 'collisions': 4}, {'tx': 8, 'success': 3, 'collisions': 5}, {'tx': 5, 'success': 1, 'collisions': 4}, {'tx': 7, 'success': 3, 'collisions': 4}, {'tx': 10, 'success': 2, 'collisions': 8}, {'tx': 4, 'success': 0, 'collisions': 4}, {'tx': 8, 'success': 2, 'collisions': 6}, {'tx': 8, 'success': 2, 'collisions': 6}, {'tx': 4, 'success': 0, 'collisions': 4}, {'tx': 7, 'success': 1, 'collisions': 6}, {'tx': 10, 'success': 5, 'collisions': 5}, {'tx': 4, 'success': 0, 'collisions': 4}, {'tx': 15, 'success': 8, 'collisions': 7}, {'tx': 9, 'success': 3, 'collisions': 6}, {'tx': 3, 'success': 0, 'collisions': 3}, {'tx': 4, 'success': 0, 'collisions': 4}, {'tx': 3, 'success': 0, 'collisions': 3}, {'tx': 4, 'success': 0, 'collisions': 4}, {'tx': 6, 'success': 1, 'collisions': 5}]"
182,30,83,216,59,157,0.7268518518518519,0.27314814814814814,0.4897,"[{'tx': 7, 'success': 2, 'collisions': 5}, {'tx': 7, 'success': 2, 'collisions': 5}, {'tx': 10, 'success': 4, 'collisions': 6}, {'tx': 6, 'success': 1, 'collisions': 5}, {'tx': 11, 'success': 5, 'collisions': 6}, {'tx': 5, 'success': 0, 'collisions': 5}, {'tx': 4, 'success': 0, 'collisions': 4}, {'tx': 7, 'success': 2, 'collisions': 5}, {'tx': 11, 'success': 3, 'collisions': 8}, {'tx': 5, 'success': 1, 'collisions': 4}, {'tx': 11, 'success': 6, 'collisions': 5}, {'tx': 4, 'success': 0, 'collisions': 4}, {'tx': 5, 'success': 1, 'collisions': 4}, {'tx': 12, 'success': 3, 'collisions': 9}, {'tx': 4, 'success': 0, 'collisions': 4}, {'tx': 10, 'success': 6, 'collisions': 4}, {'tx': 8, 'success': 3, 'collisions': 5}, {'tx': 4, 'success': 0, 'collisions': 4}, {'tx': 4, 'success': 0, 'collisions': 4}, {'tx': 12, 'success': 4, 'collisions': 8}, {'tx': 11, 'success': 3, 'collisions': 8}, {'tx': 11, 'success': 4, 'collisions': 7}, {'tx': 4, 'success': 0, 'collisions': 4}, {'tx': 6, 'success': 1, 'collisions': 5}, {'tx': 5, 'success': 1, 'collisions': 4}, {'tx': 9, 'success': 3, 'collisions': 6}, {'tx': 5, 'success': 1, 'collisions': 4}, {'tx': 4, 'success': 0, 'collisions': 4}, {'tx': 6, 'success': 1, 'collisions': 5}, {'tx': 8, 'success': 2, 'collisions': 6}]"
183,30,84,215,65,150,0.6976744186046512,0.3023255813953488,0.546,"[{'tx': 4, 'success': 0, 'collisions': 4}, {'tx': 6, 'success': 1, 'collisions': 5}, {'tx': 6, 'success': 3, 'collisions': 3}, {'tx': 13, 'success': 4, 'collisions': 9}, {'tx': 5, 'success': 1, 'collisions': 4}, {'tx': 12, 'success': 6, 'collisions': 6}, {'tx': 4, 'success': 0, 'collisions': 4}, {'tx': 6, 'success': 2, 'collisions': 4}, {'tx': 8, 'success': 3, 'collisions': 5}, {'tx': 4, 'success': 0, 'collisions': 4}, {'tx': 3, 'success': 0, 'collisions': 3}, {'tx': 4, 'success': 0, 'collisions': 4}, {'tx': 14, 'success': 6, 'collisions': 8}, {'tx': 3, 'success': 0, 'collisions': 3}, {'tx': 8, 'success': 3, 'collisions': 5}, {'tx': 3, 'success': 0, 'collisions': 3}, {'tx': 9, 'success': 2, 'collisions': 7}, {'tx': 3, 'success': 0, 'collisions': 3}, {'tx': 11, 'success': 6, 'collisions': 5}, {'tx': 10, 'success': 5, 'collisions': 5}, {'tx': 8, 'success': 2, 'collisions': 6}, {'tx': 4, 'success': 0, 'collisions': 4}, {'tx': 13, 'success': 6, 'collisions': 7}, {'tx': 4, 'success': 0, 'collisions': 4}, {'tx': 8, 'success': 2, 'collisions': 6}, {'tx': 6, 'success': 1, 'collisions': 5}, {'tx': 8, 'success': 2, 'collisions': 6}, {'tx': 8, 'success': 2, 'collisions': 6}, {'tx': 12, 'success': 5, 'collisions': 7}, {'tx': 8, 'success': 3, 'collisions': 5}]"
184,30,85,204,61,143,0.7009803921568627,0.29901960784313725,0.5185,"[{'tx': 4, 'success': 0, 'collisions': 4}, {'tx': 4, 'success': 0, 'collisions': 4}, {'tx': 7, 'success': 1, 'collisions': 6}, {'tx': 11, 'success': 6, 'collisions': 5}, {'tx': 4, 'success': 0, 'collisions': 4}, {'tx': 4, 'success': 1, 'collisions': 3}, {'tx': 15, 'success': 6, 'collisions': 9}, {'tx': 4, 'success': 0, 'collisions': 4}, {'tx': 10, 'success': 5, 'collisions': 5}, {'tx': 4, 'success': 0, 'collisions': 4}, {'tx': 6, 'success': 2, 'collisions': 4}, {'tx': 10, 'success': 5, 'collisions': 5}, {'tx': 12, 'success': 7, 'collisions': 5}, {'tx': 9, 'success': 4, 'collisions': 5}, {'tx': 4, 'success': 0, 'collisions': 4}, {'tx': 11, 'success': 6, 'collisions': 5}, {'tx': 10, 'success': 5, 'collisions': 5}, {'tx': 8, 'success': 3, 'collisions': 5}, {'tx': 6, 'success': 1, 'collisions': 5}, {'tx': 8, 'success': 2, 'collisions': 6}, {'tx': 4, 'success': 0, 'collisions': 4}, {'tx': 4, 'success': 0, 'collisions': 4}, {'tx': 5, 'success': 1, 'collisions': 4}, {'tx': 4, 'success': 0, 'collisions': 4}, {'tx': 4, 'success': 0, 'collisions': 4}, {'tx': 9, 'success': 2, 'collisions': 7}, {'tx': 5, 'success': 0, 'collisions': 5}, {'tx': 5, 'success': 1, 'collisions': 4}, {'tx': 5, 'success': 0, 'collisions': 5}, {'tx': 8, 'success': 3, 'collisions': 5}]"
185,30,86,215,62,153,0.7116279069767442,0.28837209302325584,0.5332,"[{'tx': 8, 'success': 3, 'collisions': 5}, {'tx': 10, 'success': 5, 'collisions': 5}, {'tx': 11, 'success': 5, 'collisions': 6}, {'tx': 12, 'success': 4, 'collisions': 8}, {'tx': 8, 'success': 4, 'collisions': 4}, {'tx': 6, 'success': 1, 'collisions': 5}, {'tx': 3, 'success': 0, 'collisions': 3}, {'tx': 5, 'success': 0, 'collisions': 5}, {'tx': 11, 'success': 4, 'collisions': 7}, {'tx': 8, 'success': 3, 'collisions': 5}, {'tx': 4, 'success': 0, 'collisions': 4}, {'tx': 8, 'success': 3, 'collisions': 5}, {'tx': 4, 'success': 0, 'collisions': 4}, {'tx': 4, 'success': 0, 'collisions': 4}, {'tx': 6, 'success': 1, 'collisions': 5}, {'tx': 6, 'success': 1, 'collisions': 5}, {'tx': 5, 'success': 0, 'collisions': 5}, {'tx': 10, 'success': 6, 'collisions': 4}, {'tx': 7, 'success': 2, 'collisions': 5}, {'tx': 5, 'success': 0, 'collisions': 5}, {'tx': 9, 'success': 2, 'collisions': 7}, {'tx': 3, 'success': 0, 'collisions': 3}, {'tx': 10, 'success': 5, 'collisions': 5}, {'tx': 6, 'success': 2, 'collisions': 4}, {'tx': 4, 'success': 0, 'collisions': 4}, {'tx': 8, 'success': 2, 'collisions': 6}, {'tx': 8, 'success': 3, 'collisions': 5}, {'tx': 8, 'success': 2, 'collisions': 6}, {'tx': 10, 'success': 3, 'collisions': 7}, {'tx': 8, 'success': 1, 'collisions': 7}]"
186,30,87,209,57,152,0.7272727272727273,0.2727272727272727,0.4959,"[{'tx': 4, 'success': 0, 'collisions': 4}, {'tx': 6, 'success': 2, 'collisions': 4}, {'tx': 5, 'success': 1, 'collisions': 4}, {'tx': 4, 'success': 0, 'collisions': 4}, {'tx': 9, 'success': 3, 'collisions': 6}, {'tx': 13, 'success': 7, 'collisions': 6}, {'tx': 5, 'success': 0, 'collisions': 5}, {'tx': 10, 'success': 3, 'collisions': 7}, {'tx': 4, 'success': 0, 'collisions': 4}, {'tx': 12, 'success': 4, 'collisions': 8}, {'tx': 7, 'success': 3, 'collisions': 4}, {'tx': 4, 'success': 0, 'collisions': 4}, {'tx': 6, 'success': 2, 'collisions': 4}, {'tx': 6, 'success': 1, 'collisions': 5}, {'tx': 10, 'success': 6, 'collisions': 4}, {'tx': 10, 'success': 4, 'collisions': 6}, {'tx': 5, 'success': 0, 'collisions': 5}, {'tx': 16, 'success': 7, 'collisions': 9}, {'tx': 5, 'success': 1, 'collisions': 4}, {'tx': 4, 'success': 0, 'collisions': 4}, {'tx': 5, 'success': 0, 'collisions': 5}, {'tx': 12, 'success': 4, 'collisions': 8}, {'tx': 8, 'success': 3, 'collisions': 5}, {'tx': 9, 'success': 2, 'collisions': 7}, {'tx': 6, 'success': 2, 'collisions': 4}, {'tx': 4, 'success': 0, 'collisions': 4}, {'tx': 5, 'success': 0, 'collisions': 5}, {'tx': 5, 'success': 1, 'collisions': 4}, {'tx': 6, 'success': 1, 'collisions': 5}, {'tx': 4, 'success': 0, 'collisions': 4}]"
187,30,88,200,52,148,0.74,0.26,0.4576,"[{'tx': 4, 'success': 0, 'collisions': 4}, {'tx': 8, 'success': 3, 'collisions': 5}, {'tx': 8, 'success': 3, 'collisions': 5}, {'tx': 10, 'success': 4, 'collisions': 6}, {'tx': 5, 'success': 0, 'collisions': 5}, {'tx': 3, 'success': 0, 'collisions': 3}, {'tx': 5, 'success': 0, 'collisions': 5}, {'tx': 7, 'success': 1, 'collisions': 6}, {'tx': 7, 'success': 1, 'collisions': 6}, {'tx': 9, 'success': 3, 'collisions': 6}, {'tx': 4, 'success': 0, 'collisions': 4}, {'tx': 4, 'success': 0, 'collisions': 4}, {'tx': 11, 'success': 6, 'collisions': 5}, {'tx': 4, 'success': 0, 'collisions': 4}, {'tx': 4, 'success': 0, 'collisions': 4}, {'tx': 11, 'success': 6, 'collisions': 5}, {'tx': 7, 'success': 3, 'collisions': 4}, {'tx': 12, 'success': 4, 'collisions': 8}, {'tx': 5, 'success': 0, 'collisions': 5}, {'tx': 7, 'success': 2, 'collisions': 5}, {'tx': 3, 'success': 0, 'collisions': 3}, {'tx': 4, 'success': 0, 'collisions': 4}, {'tx': 9, 'success': 3, 'collisions': 6}, {'tx': 9, 'success': 2, 'collisions': 7}, {'tx': 4, 'success': 0, 'collisions': 4}, {'tx': 4, 'success': 0, 'collisions': 4}, {'tx': 14, 'success': 7, 'collisions': 7}, {'tx': 4, 'success': 0, 'collisions': 4}, {'tx': 6, 'success': 2, 'collisions': 4}, {'tx': 8, 'success': 2, 'collisions': 6}]"
188,30,89,198,55,143,0.7222222222222222,0.2777777777777778,0.4895,"[{'tx': 8, 'success': 3, 'collisions': 5}, {'tx': 10, 'success': 3, 'collisions': 7}, {'tx': 7, 'success': 1, 'collisions': 6}, {'tx': 5, 'success': 1, 'collisions': 4}, {'tx': 8, 'success': 3, 'collisions': 5}, {'tx': 4, 'success': 0, 'collisions': 4}, {'tx': 3, 'success': 0, 'collisions': 3}, {'tx': 5, 'success': 1, 'collisions': 4}, {'tx': 4, 'success': 0, 'collisions': 4}, {'tx': 8, 'success': 3, 'collisions': 5}, {'tx': 4, 'success': 0, 'collisions': 4}, {'tx': 8, 'success': 3, 'collisions': 5}, {'tx': 11, 'success': 5, 'collisions': 6}, {'tx': 4, 'success': 0, 'collisions': 4}, {'tx': 9, 'success': 4, 'collisions': 5}, {'tx': 7, 'success': 3, 'collisions': 4}, {'tx': 7, 'success': 2, 'collisions': 5}, {'tx': 10, 'success': 3, 'collisions': 7}, {'tx': 12, 'success': 5, 'collisions': 7}, {'tx': 8, 'success': 2, 'collisions': 6}, {'tx': 7, 'success': 1, 'collisions': 6}, {'tx': 4, 'success': 0, 'collisions': 4}, {'tx': 7, 'success': 3, 'collisions': 4}, {'tx': 4, 'success': 0, 'collisions': 4}, {'tx': 10, 'success': 4, 'collisions': 6}, {'tx': 5, 'success': 0, 'collisions': 5}, {'tx': 6, 'success': 2, 'collisions': 4}, {'tx': 7, 'success': 3, 'collisions': 4}, {'tx': 3, 'success': 0, 'collisions': 3}, {'tx': 3, 'success': 0, 'collisions': 3}]"
189,30,90,204,54,150,0.7352941176470589,0.2647058823529412,0.486,"[{'tx': 8, 'success': 3, 'collisions': 5}, {'tx': 10, 'success': 4, 'collisions': 6}, {'tx': 4, 'success': 0, 'collisions': 4}, {'tx': 4, 'success': 0, 'collisions': 4}, {'tx': 5, 'success': 0, 'collisions': 5}, {'tx': 5, 'success': 1, 'collisions': 4}, {'tx': 4, 'success': 0, 'collisions': 4}, {'tx': 14, 'success': 6, 'collisions': 8}, {'tx': 14, 'success': 7, 'collisions': 7}, {'tx': 6, 'success': 1, 'collisions': 5}, {'tx': 5, 'success': 0, 'collisions': 5}, {'tx': 4, 'success': 0, 'collisions': 4}, {'tx': 10, 'success': 3, 'collisions': 7}, {'tx': 4, 'success': 0, 'collisions': 4}, {'tx': 7, 'success': 2, 'collisions': 5}, {'tx': 14, 'success': 6, 'collisions': 8}, {'tx': 4, 'success': 0, 'collisions': 4}, {'tx': 4, 'success': 0, 'collisions': 4}, {'tx': 4, 'success': 0, 'collisions': 4}, {'tx': 4, 'success': 0, 'collisions': 4}, {'tx': 11, 'success': 4, 'collisions': 7}, {'tx': 4, 'success': 0, 'collisions': 4}, {'tx': 7, 'success': 1, 'collisions': 6}, {'tx': 6, 'success': 1, 'collisions': 5}, {'tx': 11, 'success': 4, 'collisions': 7}, {'tx': 5, 'success': 1, 'collisions': 4}, {'tx': 8, 'success': 4, 'collisions': 4}, {'tx': 10, 'success': 6, 'collisions': 4}, {'tx': 4, 'success': 0, 'collisions': 4}, {'tx': 4, 'success': 0, 'collisions': 4}]"
190,30,91,194,57,137,0.7061855670103093,0.29381443298969073,0.5187,"[{'tx': 6, 'success': 2, 'collisions': 4}, {'tx': 4, 'success': 0, 'collisions': 4}, {'tx': 3, 'success': 0, 'collisions': 3}, {'tx': 11, 'success': 6, 'collisions': 5}, {'tx': 3, 'success': 0, 'collisions': 3}, {'tx': 4, 'success': 0, 'collisions': 4}, {'tx': 9, 'success': 3, 'collisions': 6}, {'tx': 10, 'success': 5, 'collisions': 5}, {'tx': 3, 'success': 0, 'collisions': 3}, {'tx': 7, 'success': 2, 'collisions': 5}, {'tx': 5, 'success': 1, 'collisions': 4}, {'tx': 4, 'success': 0, 'collisions': 4}, {'tx': 4, 'success': 0, 'collisions': 4}, {'tx': 7, 'success': 2, 'collisions': 5}, {'tx': 7, 'success': 3, 'collisions': 4}, {'tx': 9, 'success': 3, 'collisions': 6}, {'tx': 10, 'success': 3, 'collisions': 7}, {'tx': 9, 'success': 4, 'collisions': 5}, {'tx': 4, 'success': 0, 'collisions': 4}, {'tx': 4, 'success': 0, 'collisions': 4}, {'tx': 10, 'success': 5, 'collisions': 5}, {'tx': 10, 'success': 6, 'collisions': 4}, {'tx': 6, 'success': 1, 'collisions': 5}, {'tx': 10, 'success': 4, 'collisions': 6}, {'tx': 6, 'success': 1, 'collisions': 5}, {'tx': 8, 'success': 3, 'collisions': 5}, {'tx': 5, 'success': 1, 'collisions': 4}, {'tx': 8, 'success': 2, 'collisions': 6}, {'tx': 4, 'success': 0, 'collisions': 4}, {'tx': 4, 'success': 0, 'collisions': 4}]"
191,30,92,196,50,146,0.7448979591836735,0.25510204081632654,0.46,"[{'tx': 6, 'success': 2, 'collisions': 4}, {'tx': 6, 'success': 1, 'collisions': 5}, {'tx': 4, 'success': 0, 'collisions': 4}, {'tx': 11, 'success': 4, 'collisions': 7}, {'tx': 4, 'success': 0, 'collisions': 4}, {'tx': 8, 'success': 3, 'collisions': 5}, {'tx': 11, 'success': 4, 'collisions': 7}, {'tx': 7, 'success': 2, 'collisions': 5}, {'tx': 7, 'success': 2, 'collisions': 5}, {'tx': 9, 'success': 3, 'collisions': 6}, {'tx': 10, 'success': 3, 'collisions': 7}, {'tx': 5, 'success': 0, 'collisions': 5}, {'tx': 3, 'success': 0, 'collisions': 3}, {'tx': 7, 'success': 4, 'collisions': 3}, {'tx': 3, 'success': 0, 'collisions': 3}, {'tx': 4, 'success': 0, 'collisions': 4}, {'tx': 4, 'success': 0, 'collisions': 4}, {'tx': 9, 'success': 3, 'collisions': 6}, {'tx': 4, 'success': 0, 'collisions': 4}, {'tx': 6, 'success': 2, 'collisions': 4}, {'tx': 4, 'success': 0, 'collisions': 4}, {'tx': 7, 'success': 1, 'collisions': 6}, {'tx': 7, 'success': 2, 'collisions': 5}, {'tx': 8, 'success': 3, 'collisions': 5}, {'tx': 4, 'success': 0, 'collisions': 4}, {'tx': 4, 'success': 1, 'collisions': 3}, {'tx': 13, 'success': 4, 'collisions': 9}, {'tx': 6, 'success': 1, 'collisions': 5}, {'tx': 6, 'success': 1, 'collisions': 5}, {'tx': 9, 'success': 4, 'collisions': 5}]"
192,30,93,204,55,149,0.7303921568627451,0.2696078431372549,0.5115,"[{'tx': 9, 'success': 4, 'collisions': 5}, {'tx': 3, 'success': 0, 'collisions': 3}, {'tx': 9, 'success': 2, 'collisions': 7}, {'tx': 11, 'success': 5, 'collisions': 6}, {'tx': 8, 'success': 3, 'collisions': 5}, {'tx': 4, 'success': 0, 'collisions': 4}, {'tx': 6, 'success': 2, 'collisions': 4}, {'tx': 6, 'success': 2, 'collisions': 4}, {'tx': 4, 'success': 0, 'collisions': 4}, {'tx': 9, 'success': 3, 'collisions': 6}, {'tx': 4, 'success': 1, 'collisions': 3}, {'tx': 7, 'success': 3, 'collisions': 4}, {'tx': 5, 'success': 1, 'collisions': 4}, {'tx': 4, 'success': 1, 'collisions': 3}, {'tx': 5, 'success': 0, 'collisions': 5}, {'tx': 10, 'success': 3, 'collisions': 7}, {'tx': 4, 'success': 0, 'collisions': 4}, {'tx': 8, 'success': 3, 'collisions': 5}, {'tx': 4, 'success': 0, 'collisions': 4}, {'tx': 9, 'success': 3, 'collisions': 6}, {'tx': 8, 'success': 2, 'collisions': 6}, {'tx': 3, 'success': 0, 'collisions': 3}, {'tx': 7, 'success': 2, 'collisions': 5}, {'tx': 10, 'success': 4, 'collisions': 6}, {'tx': 12, 'success': 5, 'collisions': 7}, {'tx': 8, 'success': 2, 'collisions': 6}, {'tx': 6, 'success': 1, 'collisions': 5}, {'tx': 9, 'success': 2, 'collisions': 7}, {'tx': 4, 'success': 0, 'collisions': 4}, {'tx': 8, 'success': 1, 'collisions': 7}]"
193,30,94,189,59,130,0.6878306878306878,0.31216931216931215,0.5546,"[{'tx': 10, 'success': 6, 'collisions': 4}, {'tx': 3, 'success': 0, 'collisions': 3}, {'tx': 4, 'success': 0, 'collisions': 4}, {'tx': 10, 'success': 4, 'collisions': 6}, {'tx': 3, 'success': 0, 'collisions': 3}, {'tx': 7, 'success': 2, 'collisions': 5}, {'tx': 11, 'success': 6, 'collisions': 5}, {'tx': 4, 'success': 1, 'collisions': 3}, {'tx': 6, 'success': 1, 'collisions': 5}, {'tx': 3, 'success': 0, 'collisions': 3}, {'tx': 11, 'success': 4, 'collisions': 7}, {'tx': 6, 'success': 2, 'collisions': 4}, {'tx': 11, 'success': 4, 'collisions': 7}, {'tx': 5, 'success': 1, 'collisions': 4}, {'tx': 9, 'success': 4, 'collisions': 5}, {'tx': 6, 'success': 1, 'collisions': 5}, {'tx': 9, 'success': 4, 'collisions': 5}, {'tx': 4, 'success': 0, 'collisions': 4}, {'tx': 5, 'success': 1, 'collisions': 4}, {'tx': 5, 'success': 1, 'collisions': 4}, {'tx': 4, 'success': 0, 'collisions': 4}, {'tx': 12, 'success': 6, 'collisions': 6}, {'tx': 4, 'success': 0, 'collisions': 4}, {'tx': 3, 'success': 0, 'collisions': 3}, {'tx': 7, 'success': 4, 'collisions': 3}, {'tx': 4, 'success': 0, 'collisions': 4}, {'tx': 3, 'success': 0, 'collisions': 3}, {'tx': 6, 'success': 1, 'collisions': 5}, {'tx': 10, 'success': 6, 'collisions': 4}, {'tx': 4, 'success': 0, 'collisions': 4}]"
194,30,95,182,54,128,0.7032967032967034,0.2967032967032967,0.513,"[{'tx': 8, 'success': 2, 'collisions': 6}, {'tx': 9, 'success': 4, 'collisions': 5}, {'tx': 3, 'success': 0, 'collisions': 3}, {'tx': 11, 'success': 8, 'collisions': 3}, {'tx': 4, 'success': 0, 'collisions': 4}, {'tx': 3, 'success': 0, 'collisions': 3}, {'tx': 11, 'success': 5, 'collisions': 6}, {'tx': 6, 'success': 2, 'collisions': 4}, {'tx': 10, 'success': 5, 'collisions': 5}, {'tx': 3, 'success': 0, 'collisions': 3}, {'tx': 4, 'success': 0, 'collisions': 4}, {'tx': 4, 'success': 1, 'collisions': 3}, {'tx': 4, 'success': 0, 'collisions': 4}, {'tx': 5, 'success': 0, 'collisions': 5}, {'tx': 3, 'success': 0, 'collisions': 3}, {'tx': 4, 'success': 0, 'collisions': 4}, {'tx': 6, 'success': 1, 'collisions': 5}, {'tx': 6, 'success': 1, 'collisions': 5}, {'tx': 5, 'success': 2, 'collisions': 3}, {'tx': 12, 'success': 7, 'collisions': 5}, {'tx': 8, 'success': 3, 'collisions': 5}, {'tx': 4, 'success': 0, 'collisions': 4}, {'tx': 5, 'success': 1, 'collisions': 4}, {'tx': 6, 'success': 1, 'collisions': 5}, {'tx': 4, 'success': 0, 'collisions': 4}, {'tx': 8, 'success': 3, 'collisions': 5}, {'tx': 5, 'success': 1, 'collisions': 4}, {'tx': 7, 'success': 2, 'collisions': 5}, {'tx': 10, 'success': 5, 'collisions': 5}, {'tx': 4, 'success': 0, 'collisions': 4}]"
195,30,96,189,49,140,0.7407407407407407,0.25925925925925924,0.4704,"[{'tx': 8, 'success': 2, 'collisions': 6}, {'tx': 3, 'success': 0, 'collisions': 3}, {'tx': 3, 'success': 0, 'collisions': 3}, {'tx': 3, 'success': 0, 'collisions': 3}, {'tx': 3, 'success': 0, 'collisions': 3}, {'tx': 9, 'success': 4, 'collisions': 5}, {'tx': 3, 'success': 0, 'collisions': 3}, {'tx': 12, 'success': 4, 'collisions': 8}, {'tx': 3, 'success': 0, 'collisions': 3}, {'tx': 9, 'success': 5, 'collisions': 4}, {'tx': 5, 'success': 0, 'collisions': 5}, {'tx': 7, 'success': 2, 'collisions': 5}, {'tx': 6, 'success': 1, 'collisions': 5}, {'tx': 8, 'success': 1, 'collisions': 7}, {'tx': 4, 'success': 0, 'collisions': 4}, {'tx': 4, 'success': 0, 'collisions': 4}, {'tx': 9, 'success': 4, 'collisions': 5}, {'tx': 8, 'success': 3, 'collisions': 5}, {'tx': 5, 'success': 0, 'collisions': 5}, {'tx': 11, 'success': 4, 'collisions': 7}, {'tx': 3, 'success': 0, 'collisions': 3}, {'tx': 11, 'success': 5, 'collisions': 6}, {'tx': 9, 'success': 4, 'collisions': 5}, {'tx': 3, 'success': 0, 'collisions': 3}, {'tx': 4, 'success': 0, 'collisions': 4}, {'tx': 5, 'success': 1, 'collisions': 4}, {'tx': 6, 'success': 2, 'collisions': 4}, {'tx': 7, 'success': 2, 'collisions': 5}, {'tx': 10, 'success': 3, 'collisions': 7}, {'tx': 8, 'success': 2, 'collisions': 6}]"
196,30,97,178,57,121,0.6797752808988764,0.3202247191011236,0.5529,"[{'tx': 7, 'success': 3, 'collisions': 4}, {'tx': 5, 'success': 0, 'collisions': 5}, {'tx': 5, 'success': 0, 'collisions': 5}, {'tx': 7, 'success': 3, 'collisions': 4}, {'tx': 6, 'success': 2, 'collisions': 4}, {'tx': 5, 'success': 1, 'collisions': 4}, {'tx': 7, 'success': 2, 'collisions': 5}, {'tx': 14, 'success': 9, 'collisions': 5}, {'tx': 6, 'success': 1, 'collisions': 5}, {'tx': 5, 'success': 1, 'collisions': 4}, {'tx': 11, 'success': 6, 'collisions': 5}, {'tx': 7, 'success': 1, 'collisions': 6}, {'tx': 6, 'success': 2, 'collisions': 4}, {'tx': 7, 'success': 4, 'collisions': 3}, {'tx': 9, 'success': 4, 'collisions': 5}, {'tx': 3, 'success': 0, 'collisions': 3}, {'tx': 4, 'success': 1, 'collisions': 3}, {'tx': 9, 'success': 6, 'collisions': 3}, {'tx': 9, 'success': 4, 'collisions': 5}, {'tx': 4, 'success': 1, 'collisions': 3}, {'tx': 4, 'success': 0, 'collisions': 4}, {'tx': 3, 'success': 0, 'collisions': 3}, {'tx': 3, 'success': 0, 'collisions': 3}, {'tx': 8, 'success': 3, 'collisions': 5}, {'tx': 4, 'success': 1, 'collisions': 3}, {'tx': 3, 'success': 0, 'collisions': 3}, {'tx': 4, 'success': 0, 'collisions': 4}, {'tx': 5, 'success': 1, 'collisions': 4}, {'tx': 3, 'success': 0, 'collisions': 3}, {'tx': 5, 'success': 1, 'collisions': 4}]"
197,30,98,187,53,134,0.7165775401069518,0.28342245989304815,0.5194,"[{'tx': 5, 'success': 2, 'collisions': 3}, {'tx': 11, 'success': 5, 'collisions': 6}, {'tx': 9, 'success': 3, 'collisions': 6}, {'tx': 6, 'success': 2, 'collisions': 4}, {'tx': 6, 'success': 2, 'collisions': 4}, {'tx': 6, 'success': 1, 'collisions': 5}, {'tx': 4, 'success': 0, 'collisions': 4}, {'tx': 9, 'success': 3, 'collisions': 6}, {'tx': 5, 'success': 1, 'collisions': 4}, {'tx': 9, 'success': 3, 'collisions': 6}, {'tx': 4, 'success': 0, 'collisions': 4}, {'tx': 4, 'success': 0, 'collisions': 4}, {'tx': 6, 'success': 1, 'collisions': 5}, {'tx': 11, 'success': 5, 'collisions': 6}, {'tx': 3, 'success': 0, 'collisions': 3}, {'tx': 5, 'success': 2, 'collisions': 3}, {'tx': 9, 'success': 4, 'collisions': 5}, {'tx': 3, 'success': 0, 'collisions': 3}, {'tx': 5, 'success': 1, 'collisions': 4}, {'tx': 6, 'success': 3, 'collisions': 3}, {'tx': 3, 'success': 0, 'collisions': 3}, {'tx': 6, 'success': 1, 'collisions': 5}, {'tx': 5, 'success': 1, 'collisions': 4}, {'tx': 10, 'success': 5, 'collisions': 5}, {'tx': 4, 'success': 0, 'collisions': 4}, {'tx': 8, 'success': 4, 'collisions': 4}, {'tx': 6, 'success': 1, 'collisions': 5}, {'tx': 7, 'success': 2, 'collisions': 5}, {'tx': 7, 'success': 1, 'collisions': 6}, {'tx': 5, 'success': 0, 'collisions': 5}]"
198,30,99,181,51,130,0.7182320441988951,0.281767955801105,0.5049,"[{'tx': 6, 'success': 2, 'collisions': 4}, {'tx': 9, 'success': 5, 'collisions': 4}, {'tx': 4, 'success': 0, 'collisions': 4}, {'tx': 4, 'success': 0, 'collisions': 4}, {'tx': 10, 'success': 3, 'collisions': 7}, {'tx': 4, 'success': 0, 'collisions': 4}, {'tx': 5, 'success': 1, 'collisions': 4}, {'tx': 3, 'success': 0, 'collisions': 3}, {'tx': 3, 'success': 0, 'collisions': 3}, {'tx': 3, 'success': 0, 'collisions': 3}, {'tx': 5, 'success': 1, 'collisions': 4}, {'tx': 6, 'success': 1, 'collisions': 5}, {'tx': 3, 'success': 0, 'collisions': 3}, {'tx': 5, 'success': 1, 'collisions': 4}, {'tx': 3, 'success': 0, 'collisions': 3}, {'tx': 12, 'success': 6, 'collisions': 6}, {'tx': 11, 'success': 6, 'collisions': 5}, {'tx': 10, 'success': 5, 'collisions': 5}, {'tx': 5, 'success': 1, 'collisions': 4}, {'tx': 7, 'success': 2, 'collisions': 5}, {'tx': 7, 'success': 2, 'collisions': 5}, {'tx': 3, 'success': 0, 'collisions': 3}, {'tx': 7, 'success': 2, 'collisions': 5}, {'tx': 4, 'success': 0, 'collisions': 4}, {'tx': 8, 'success': 2, 'collisions': 6}, {'tx': 9, 'success': 4, 'collisions': 5}, {'tx': 5, 'success': 0, 'collisions': 5}, {'tx': 7, 'success': 2, 'collisions': 5}, {'tx': 3, 'success': 0, 'collisions': 3}, {'tx': 10, 'success': 5, 'collisions': 5}]"
199,30,100,182,47,135,0.7417582417582418,0.25824175824175827,0.47,"[{'tx': 7, 'success': 2, 'collisions': 5}, {'tx': 7, 'success': 2, 'collisions': 5}, {'tx': 5, 'success': 1, 'collisions': 4}, {'tx': 10, 'success': 5, 'collisions': 5}, {'tx': 4, 'success': 0, 'collisions': 4}, {'tx': 3, 'success': 0, 'collisions': 3}, {'tx': 5, 'success': 0, 'collisions': 5}, {'tx': 7, 'success': 2, 'collisions': 5}, {'tx': 4, 'success': 0, 'collisions': 4}, {'tx': 11, 'success': 7, 'collisions': 4}, {'tx': 8, 'success': 2, 'collisions': 6}, {'tx': 6, 'success': 1, 'collisions': 5}, {'tx': 4, 'success': 0, 'collisions': 4}, {'tx': 8, 'success': 3, 'collisions': 5}, {'tx': 3, 'success': 0, 'collisions': 3}, {'tx': 3, 'success': 0, 'collisions': 3}, {'tx': 4, 'success': 0, 'collisions': 4}, {'tx': 4, 'success': 0, 'collisions': 4}, {'tx': 4, 'success': 0, 'collisions': 4}, {'tx': 9, 'success': 3, 'collisions': 6}, {'tx': 4, 'success': 0, 'collisions': 4}, {'tx': 10, 'success': 5, 'collisions': 5}, {'tx': 7, 'success': 3, 'collisions': 4}, {'tx': 11, 'success': 4, 'collisions': 7}, {'tx': 7, 'success': 2, 'collisions': 5}, {'tx': 5, 'success': 0, 'collisions': 5}, {'tx': 8, 'success': 4, 'collisions': 4}, {'tx': 4, 'success': 0, 'collisions': 4}, {'tx': 4, 'success': 0, 'collisions': 4}, {'tx': 6, 'success': 1, 'collisions': 5}]"
200,40,1,8425,3660,4765,0.5655786350148369,0.4344213649851632,0.366,"[{'tx': 160, 'success': 68, 'collisions': 92}, {'tx': 445, 'success': 223, 'collisions': 222}, {'tx': 150, 'success': 58, 'collisions': 92}, {'tx': 229, 'success': 100, 'collisions': 129}, {'tx': 160, 'success': 70, 'collisions': 90}, {'tx': 168, 'success': 74, 'collisions': 94}, {'tx': 165, 'success': 66, 'collisions': 99}, {'tx': 314, 'success': 149, 'collisions': 165}, {'tx': 259, 'success': 109, 'collisions': 150}, {'tx': 378, 'success': 177, 'collisions': 201}, {'tx': 187, 'success': 76, 'collisions': 111}, {'tx': 183, 'success': 78, 'collisions': 105}, {'tx': 276, 'success': 122, 'collisions': 154}, {'tx': 154, 'success': 59, 'collisions': 95}, {'tx': 180, 'success': 67, 'collisions': 113}, {'tx': 193, 'success': 79, 'collisions': 114}, {'tx': 166, 'success': 66, 'collisions': 100}, {'tx': 301, 'success': 141, 'collisions': 160}, {'tx': 306, 'success': 139, 'collisions': 167}, {'tx': 274, 'success': 114, 'collisions': 160}, {'tx': 212, 'success': 89, 'collisions': 123}, {'tx': 122, 'success': 42, 'collisions': 80}, {'tx': 130, 'success': 49, 'collisions': 81}, {'tx': 209, 'success': 85, 'collisions': 124}, {'tx': 168, 'success': 68, 'collisions': 100}, {'tx': 255, 'success': 110, 'collisions': 145}, {'tx': 159, 'success': 64, 'collisions': 95}, {'tx': 106, 'success': 42, 'collisions': 64}, {'tx': 263, 'success': 123, 'collisions': 140}, {'tx': 227, 'success': 104, 'collisions': 123}, {'tx': 286, 'success': 125, 'collisions': 161}, {'tx': 155, 'success': 73, 'collisions': 82}, {'tx': 247, 'success': 103, 'collisions': 144}, {'tx': 210, 'success': 98, 'collisions': 112}, {'tx': 106, 'success': 46, 'collisions': 60}, {'tx': 21, 'success': 1, 'collisions': 20}, {'tx': 221, 'success': 100, 'collisions': 121}, {'tx': 129, 'success': 54, 'collisions': 75}, {'tx': 377, 'success': 174, 'collisions': 203}, {'tx': 174, 'success': 75, 'collisions': 99}]"
201,40,2,5406,2355,3051,0.5643729189789123,0.43562708102108766,0.471,"[{'tx': 127, 'success': 49, 'collisions': 78}, {'tx': 171, 'success': 77, 'collisions': 94}, {'tx': 147, 'success': 61, 'collisions': 86}, {'tx': 94, 'success': 43, 'collisions': 51}, {'tx': 99, 'success': 34, 'collisions': 65}, {'tx': 112, 'success': 51, 'collisions': 61}, {'tx': 164, 'success': 76, 'collisions': 88}, {'tx': 256, 'success': 123, 'collisions': 133}, {'tx': 152, 'success': 54, 'collisions': 98}, {'tx': 20, 'success': 2, 'collisions': 18}, {'tx': 62, 'success': 25, 'collisions': 37}, {'tx': 174, 'success': 82, 'collisions': 92}, {'tx': 214, 'success': 95, 'collisions': 119}, {'tx': 65, 'success': 26, 'collisions': 39}, {'tx': 174, 'success': 77, 'collisions': 97}, {'tx': 182, 'success': 90, 'collisions': 92}, {'tx': 151, 'success': 66, 'collisions': 85}, {'tx': 17, 'success': 2, 'collisions': 15}, {'tx': 226, 'success': 111, 'collisions': 115}, {'tx': 77, 'success': 23, 'collisions': 54}, {'tx': 84, 'success': 29, 'collisions': 55}, {'tx': 195, 'success': 88, 'collisions': 107}, {'tx': 162, 'success': 81, 'collisions': 81}, {'tx': 190, 'success': 83, 'collisions': 107}, {'tx': 181, 'success': 86, 'collisions': 95}, {'tx': 73, 'success': 20, 'collisions': 53}, {'tx': 89, 'success': 39, 'collisions': 50}, {'tx': 141, 'success': 57, 'collisions': 84}, {'tx': 69, 'success': 23, 'collisions': 46}, {'tx': 200, 'success': 91, 'collisions': 109}, {'tx': 212, 'success': 100, 'collisions': 112}, {'tx': 152, 'success': 76, 'collisions': 76}, {'tx': 66, 'success': 29, 'collisions': 37}, {'tx': 103, 'success': 45, 'collisions': 58}, {'tx': 178, 'success': 83, 'collisions': 95}, {'tx': 138, 'success': 56, 'collisions': 82}, {'tx': 82, 'success': 30, 'collisions': 52}, {'tx': 21, 'success': 5, 'collisions': 16}, {'tx': 211, 'success': 101, 'collisions': 110}, {'tx': 175, 'success': 66, 'collisions': 109}]"
202,40,3,3942,1713,2229,0.5654490106544902,0.4345509893455099,0.5139,"[{'tx': 145, 'success': 67, 'collisions': 78}, {'tx': 68, 'success': 29, 'collisions': 39}, {'tx': 139, 'success': 61, 'collisions': 78}, {'tx': 54, 'success': 16, 'collisions': 38}, {'tx': 82, 'success': 32, 'collisions': 50}, {'tx': 57, 'success': 19, 'collisions': 38}, {'tx': 51, 'success': 17, 'collisions': 34}, {'tx': 92, 'success': 34, 'collisions': 58}, {'tx': 84, 'success': 43, 'collisions': 41}, {'tx': 181, 'success': 86, 'collisions': 95}, {'tx': 109, 'success': 48, 'collisions': 61}, {'tx': 183, 'success': 86, 'collisions': 97}, {'tx': 20, 'success': 3, 'collisions': 17}, {'tx': 119, 'success': 52, 'collisions': 67}, {'tx': 51, 'success': 18, 'collisions': 33}, {'tx': 87, 'success': 36, 'collisions': 51}, {'tx': 69, 'success': 22, 'collisions': 47}, {'tx': 84, 'success': 33, 'collisions': 51}, {'tx': 128, 'success': 63, 'collisions': 65}, {'tx': 47, 'success': 17, 'collisions': 30}, {'tx': 226, 'success': 114, 'collisions': 112}, {'tx': 129, 'success': 58, 'collisions': 71}, {'tx': 88, 'success': 35, 'collisions': 53}, {'tx': 109, 'success': 56, 'collisions': 53}, {'tx': 150, 'success': 73, 'collisions': 77}, {'tx': 72, 'success': 29, 'collisions': 43}, {'tx': 90, 'success': 36, 'collisions': 54}, {'tx': 60, 'success': 26, 'collisions': 34}, {'tx': 101, 'success': 45, 'collisions': 56}, {'tx': 61, 'success': 30, 'collisions': 31}, {'tx': 20, 'success': 3, 'collisions': 17}, {'tx': 183, 'success': 87, 'collisions': 96}, {'tx': 58, 'success': 23, 'collisions': 35}, {'tx': 136, 'success': 63, 'collisions': 73}, {'tx': 126, 'success': 58, 'collisions': 68}, {'tx': 113, 'success': 42, 'collisions': 71}, {'tx': 17, 'success': 1, 'collisions': 16}, {'tx': 76, 'success': 27, 'collisions': 49}, {'tx': 156, 'success': 69, 'collisions': 87}, {'tx': 121, 'success': 56, 'collisions': 65}]"
203,40,4,3099,1323,1776,0.5730880929332043,0.4269119070667957,0.5292,"[{'tx': 104, 'success': 44, 'collisions': 60}, {'tx': 62, 'success': 22, 'collisions': 40}, {'tx': 149, 'success': 62, 'collisions': 87}, {'tx': 74, 'success': 34, 'collisions': 40}, {'tx': 40, 'success': 12, 'collisions': 28}, {'tx': 54, 'success': 21, 'collisions': 33}, {'tx': 77, 'success': 33, 'collisions': 44}, {'tx': 34, 'success': 9, 'collisions': 25}, {'tx': 52, 'success': 16, 'collisions': 36}, {'tx': 119, 'success': 52, 'collisions': 67}, {'tx': 90, 'success': 39, 'collisions': 51}, {'tx': 140, 'success': 69, 'collisions': 71}, {'tx': 109, 'success': 55, 'collisions': 54}, {'tx': 120, 'success': 54, 'collisions': 66}, {'tx': 72, 'success': 26, 'collisions': 46}, {'tx': 23, 'success': 6, 'collisions': 17}, {'tx': 115, 'success': 55, 'collisions': 60}, {'tx': 109, 'success': 52, 'collisions': 57}, {'tx': 15, 'success': 2, 'collisions': 13}, {'tx': 25, 'success': 7, 'collisions': 18}, {'tx': 46, 'success': 17, 'collisions': 29}, {'tx': 68, 'success': 29, 'collisions': 39}, {'tx': 74, 'success': 31, 'collisions': 43}, {'tx': 81, 'success': 35, 'collisions': 46}, {'tx': 122, 'success': 57, 'collisions': 65}, {'tx': 24, 'success': 5, 'collisions': 19}, {'tx': 67, 'success': 21, 'collisions': 46}, {'tx': 111, 'success': 50, 'collisions': 61}, {'tx': 147, 'success': 77, 'collisions': 70}, {'tx': 11, 'success': 0, 'collisions': 11}, {'tx': 94, 'success': 44, 'collisions': 50}, {'tx': 118, 'success': 52, 'collisions': 66}, {'tx': 63, 'success': 26, 'collisions': 37}, {'tx': 8, 'success': 0, 'collisions': 8}, {'tx': 145, 'success': 68, 'collisions': 77}, {'tx': 26, 'success': 8, 'collisions': 18}, {'tx': 130, 'success': 58, 'collisions': 72}, {'tx': 8, 'success': 0, 'collisions': 8}, {'tx': 75, 'success': 29, 'collisions': 46}, {'tx': 98, 'success': 46, 'collisions': 52}]"
204,40,5,2697,1114,1583,0.5869484612532443,0.41305153874675565,0.557,"[{'tx': 31, 'success': 10, 'collisions': 21}, {'tx': 13, 'success': 1, 'collisions': 12}, {'tx': 83, 'success': 34, 'collisions': 49}, {'tx': 15, 'success': 4, 'collisions': 11}, {'tx': 100, 'success': 35, 'collisions': 65}, {'tx': 63, 'success': 30, 'collisions': 33}, {'tx': 54, 'success': 26, 'collisions': 28}, {'tx': 133, 'success': 62, 'collisions': 71}, {'tx': 44, 'success': 12, 'collisions': 32}, {'tx': 75, 'success': 38, 'collisions': 37}, {'tx': 80, 'success': 28, 'collisions': 52}, {'tx': 39, 'success': 16, 'collisions': 23}, {'tx': 97, 'success': 41, 'collisions': 56}, {'tx': 87, 'success': 31, 'collisions': 56}, {'tx': 77, 'success': 30, 'collisions': 47}, {'tx': 131, 'success': 63, 'collisions': 68}, {'tx': 12, 'success': 1, 'collisions': 11}, {'tx': 70, 'success': 30, 'collisions': 40}, {'tx': 141, 'success': 65, 'collisions': 76}, {'tx': 109, 'success': 50, 'collisions': 59}, {'tx': 52, 'success': 20, 'collisions': 32}, {'tx': 79, 'success': 34, 'collisions': 45}, {'tx': 87, 'success': 39, 'collisions': 48}, {'tx': 85, 'success': 39, 'collisions': 46}, {'tx': 23, 'success': 5, 'collisions': 18}, {'tx': 60, 'success': 27, 'collisions': 33}, {'tx': 71, 'success': 31, 'collisions': 40}, {'tx': 51, 'success': 23, 'collisions': 28}, {'tx': 74, 'success': 28, 'collisions': 46}, {'tx': 26, 'success': 6, 'collisions': 20}, {'tx': 91, 'success': 44, 'collisions': 47}, {'tx': 90, 'success': 41, 'collisions': 49}, {'tx': 22, 'success': 6, 'collisions': 16}, {'tx': 26, 'success': 6, 'collisions': 20}, {'tx': 107, 'success': 39, 'collisions': 68}, {'tx': 18, 'success': 6, 'collisions': 12}, {'tx': 89, 'success': 37, 'collisions': 52}, {'tx': 69, 'success': 29, 'collisions': 40}, {'tx': 79, 'success': 33, 'collisions': 46}, {'tx': 44, 'success': 14, 'collisions': 30}]"
205,40,6,2256,932,1324,0.5868794326241135,0.41312056737588654,0.5592,"[{'tx': 78, 'success': 33, 'collisions': 45}, {'tx': 40, 'success': 13, 'collisions': 27}, {'tx': 76, 'success': 32, 'collisions': 44}, {'tx': 15, 'success': 2, 'collisions': 13}, {'tx': 72, 'success': 27, 'collisions': 45}, {'tx': 48, 'success': 22, 'collisions': 26}, {'tx': 74, 'success': 34, 'collisions': 40}, {'tx': 44, 'success': 17, 'collisions': 27}, {'tx': 86, 'success': 37, 'collisions': 49}, {'tx': 121, 'success': 63, 'collisions': 58}, {'tx': 14, 'success': 2, 'collisions': 12}, {'tx': 106, 'success': 51, 'collisions': 55}, {'tx': 8, 'success': 0, 'collisions': 8}, {'tx': 16, 'success': 3, 'collisions': 13}, {'tx': 14, 'success': 4, 'collisions': 10}, {'tx': 29, 'success': 8, 'collisions': 21}, {'tx': 83, 'success': 39, 'collisions': 44}, {'tx': 100, 'success': 45, 'collisions': 55}, {'tx': 34, 'success': 16, 'collisions': 18}, {'tx': 67, 'success': 28, 'collisions': 39}, {'tx': 84, 'success': 45, 'collisions': 39}, {'tx': 31, 'success': 9, 'collisions': 22}, {'tx': 21, 'success': 5, 'collisions': 16}, {'tx': 87, 'success': 36, 'collisions': 51}, {'tx': 98, 'success': 44, 'collisions': 54}, {'tx': 9, 'success': 1, 'collisions': 8}, {'tx': 53, 'success': 18, 'collisions': 35}, {'tx': 98, 'success': 45, 'collisions': 53}, {'tx': 16, 'success': 2, 'collisions': 14}, {'tx': 40, 'success': 11, 'collisions': 29}, {'tx': 93, 'success': 40, 'collisions': 53}, {'tx': 16, 'success': 2, 'collisions': 14}, {'tx': 63, 'success': 26, 'collisions': 37}, {'tx': 63, 'success': 23, 'collisions': 40}, {'tx': 25, 'success': 7, 'collisions': 18}, {'tx': 64, 'success': 26, 'collisions': 38}, {'tx': 34, 'success': 10, 'collisions': 24}, {'tx': 10, 'success': 1, 'collisions': 9}, {'tx': 109, 'success': 52, 'collisions': 57}, {'tx': 117, 'success': 53, 'collisions': 64}]"
206,40,7,1981,780,1201,0.6062594649167087,0.39374053508329127,0.546,"[{'tx': 51, 'success': 17, 'collisions': 34}, {'tx': 28, 'success': 8, 'collisions': 20}, {'tx': 10, 'success': 1, 'collisions': 9}, {'tx': 68, 'success': 28, 'collisions': 40}, {'tx': 49, 'success': 19, 'collisions': 30}, {'tx': 9, 'success': 0, 'collisions': 9}, {'tx': 34, 'success': 12, 'collisions': 22}, {'tx': 43, 'success': 14, 'collisions': 29}, {'tx': 74, 'success': 31, 'collisions': 43}, {'tx': 21, 'success': 6, 'collisions': 15}, {'tx': 33, 'success': 9, 'collisions': 24}, {'tx': 36, 'success': 10, 'collisions': 26}, {'tx': 8, 'success': 0, 'collisions': 8}, {'tx': 67, 'success': 28, 'collisions': 39}, {'tx': 102, 'success': 55, 'collisions': 47}, {'tx': 84, 'success': 35, 'collisions': 49}, {'tx': 38, 'success': 13, 'collisions': 25}, {'tx': 65, 'success': 28, 'collisions': 37}, {'tx': 75, 'success': 31, 'collisions': 44}, {'tx': 95, 'success': 40, 'collisions': 55}, {'tx': 38, 'success': 12, 'collisions': 26}, {'tx': 20, 'success': 6, 'collisions': 14}, {'tx': 100, 'success': 51, 'collisions': 49}, {'tx': 83, 'success': 36, 'collisions': 47}, {'tx': 7, 'success': 0, 'collisions': 7}, {'tx': 22, 'success': 4, 'collisions': 18}, {'tx': 9, 'success': 0, 'collisions': 9}, {'tx': 84, 'success': 34, 'collisions': 50}, {'tx': 104, 'success': 47, 'collisions': 57}, {'tx': 78, 'success': 35, 'collisions': 43}, {'tx': 49, 'success': 22, 'collisions': 27}, {'tx': 49, 'success': 22, 'collisions': 27}, {'tx': 71, 'success': 31, 'collisions': 40}, {'tx': 81, 'success': 34, 'collisions': 47}, {'tx': 78, 'success': 32, 'collisions': 46}, {'tx': 12, 'success': 1, 'collisions': 11}, {'tx': 48, 'success': 14, 'collisions': 34}, {'tx': 7, 'success': 0, 'collisions': 7}, {'tx': 39, 'success': 13, 'collisions': 26}, {'tx': 12, 'success': 1, 'collisions': 11}]"
207,40,8,1784,705,1079,0.6048206278026906,0.3951793721973094,0.564,"[{'tx': 16, 'success': 3, 'collisions': 13}, {'tx': 55, 'success': 25, 'collisions': 30}, {'tx': 35, 'success': 14, 'collisions': 21}, {'tx': 58, 'success': 20, 'collisions': 38}, {'tx': 26, 'success': 9, 'collisions': 17}, {'tx': 35, 'success': 11, 'collisions': 24}, {'tx': 76, 'success': 31, 'collisions': 45}, {'tx': 93, 'success': 51, 'collisions': 42}, {'tx': 27, 'success': 13, 'collisions': 14}, {'tx': 43, 'success': 17, 'collisions': 26}, {'tx': 19, 'success': 3, 'collisions': 16}, {'tx': 21, 'success': 5, 'collisions': 16}, {'tx': 42, 'success': 14, 'collisions': 28}, {'tx': 33, 'success': 14, 'collisions': 19}, {'tx': 26, 'success': 9, 'collisions': 17}, {'tx': 67, 'success': 26, 'collisions': 41}, {'tx': 49, 'success': 18, 'collisions': 31}, {'tx': 36, 'success': 14, 'collisions': 22}, {'tx': 72, 'success': 37, 'collisions': 35}, {'tx': 14, 'success': 4, 'collisions': 10}, {'tx': 47, 'success': 16, 'collisions': 31}, {'tx': 64, 'success': 23, 'collisions': 41}, {'tx': 42, 'success': 16, 'collisions': 26}, {'tx': 60, 'success': 25, 'collisions': 35}, {'tx': 9, 'success': 1, 'collisions': 8}, {'tx': 46, 'success': 16, 'collisions': 30}, {'tx': 66, 'success': 28, 'collisions': 38}, {'tx': 43, 'success': 17, 'collisions': 26}, {'tx': 8, 'success': 1, 'collisions': 7}, {'tx': 78, 'success': 33, 'collisions': 45}, {'tx': 44, 'success': 20, 'collisions': 24}, {'tx': 81, 'success': 34, 'collisions': 47}, {'tx': 39, 'success': 15, 'collisions': 24}, {'tx': 41, 'success': 13, 'collisions': 28}, {'tx': 29, 'success': 7, 'collisions': 22}, {'tx': 15, 'success': 3, 'collisions': 12}, {'tx': 80, 'success': 37, 'collisions': 43}, {'tx': 39, 'success': 19, 'collisions': 20}, {'tx': 42, 'success': 14, 'collisions': 28}, {'tx': 68, 'success': 29, 'collisions': 39}]"
208,40,9,1600,642,958,0.59875,0.40125,0.5778,"[{'tx': 50, 'success': 19, 'collisions': 31}, {'tx': 39, 'success': 17, 'collisions': 22}, {'tx': 33, 'success': 8, 'collisions': 25}, {'tx': 64, 'success': 32, 'collisions': 32}, {'tx': 65, 'success': 34, 'collisions': 31}, {'tx': 27, 'success': 7, 'collisions': 20}, {'tx': 30, 'success': 11, 'collisions': 19}, {'tx': 77, 'success': 41, 'collisions': 36}, {'tx': 7, 'success': 0, 'collisions': 7}, {'tx': 45, 'success': 17, 'collisions': 28}, {'tx': 47, 'success': 21, 'collisions': 26}, {'tx': 39, 'success': 14, 'collisions': 25}, {'tx': 79, 'success': 38, 'collisions': 41}, {'tx': 27, 'success': 8, 'collisions': 19}, {'tx': 76, 'success': 38, 'collisions': 38}, {'tx': 40, 'success': 15, 'collisions': 25}, {'tx': 33, 'success': 9, 'collisions': 24}, {'tx': 15, 'success': 4, 'collisions': 11}, {'tx': 28, 'success': 10, 'collisions': 18}, {'tx': 26, 'success': 7, 'collisions': 19}, {'tx': 22, 'success': 5, 'collisions': 17}, {'tx': 52, 'success': 22, 'collisions': 30}, {'tx': 24, 'success': 6, 'collisions': 18}, {'tx': 21, 'success': 6, 'collisions': 15}, {'tx': 70, 'success': 34, 'collisions': 36}, {'tx': 58, 'success': 23, 'collisions': 35}, {'tx': 37, 'success': 15, 'collisions': 22}, {'tx': 37, 'success': 12, 'collisions': 25}, {'tx': 7, 'success': 0, 'collisions': 7}, {'tx': 66, 'success': 28, 'collisions': 38}, {'tx': 95, 'success': 46, 'collisions': 49}, {'tx': 63, 'success': 28, 'collisions': 35}, {'tx': 14, 'success': 4, 'collisions': 10}, {'tx': 52, 'success': 24, 'collisions': 28}, {'tx': 12, 'success': 1, 'collisions': 11}, {'tx': 29, 'success': 9, 'collisions': 20}, {'tx': 65, 'success': 26, 'collisions': 39}, {'tx': 13, 'success': 2, 'collisions': 11}, {'tx': 9, 'success': 1, 'collisions': 8}, {'tx': 7, 'success': 0, 'collisions': 7}]"
209,40,10,1494,574,920,0.6157965194109772,0.38420348058902276,0.574,"[{'tx': 16, 'success': 4, 'collisions': 12}, {'tx': 56, 'success': 25, 'collisions': 31}, {'tx': 64, 'success': 32, 'collisions': 32}, {'tx': 46, 'success': 20, 'collisions': 26}, {'tx': 43, 'success': 20, 'collisions': 23}, {'tx': 56, 'success': 24, 'collisions': 32}, {'tx': 38, 'success': 12, 'collisions': 26}, {'tx': 30, 'success': 11, 'collisions': 19}, {'tx': 31, 'success': 13, 'collisions': 18}, {'tx': 14, 'success': 3, 'collisions': 11}, {'tx': 43, 'success': 17, 'collisions': 26}, {'tx': 47, 'success': 18, 'collisions': 29}, {'tx': 50, 'success': 19, 'collisions': 31}, {'tx': 24, 'success': 5, 'collisions': 19}, {'tx': 19, 'success': 6, 'collisions': 13}, {'tx': 13, 'success': 2, 'collisions': 11}, {'tx': 66, 'success': 25, 'collisions': 41}, {'tx': 7, 'success': 0, 'collisions': 7}, {'tx': 37, 'success': 12, 'collisions': 25}, {'tx': 41, 'success': 14, 'collisions': 27}, {'tx': 11, 'success': 1, 'collisions': 10}, {'tx': 16, 'success': 3, 'collisions': 13}, {'tx': 23, 'success': 6, 'collisions': 17}, {'tx': 43, 'success': 15, 'collisions': 28}, {'tx': 43, 'success': 18, 'collisions': 25}, {'tx': 22, 'success': 5, 'collisions': 17}, {'tx': 30, 'success': 11, 'collisions': 19}, {'tx': 54, 'success': 24, 'collisions': 30}, {'tx': 63, 'success': 28, 'collisions': 35}, {'tx': 34, 'success': 11, 'collisions': 23}, {'tx': 48, 'success': 21, 'collisions': 27}, {'tx': 9, 'success': 1, 'collisions': 8}, {'tx': 56, 'success': 22, 'collisions': 34}, {'tx': 46, 'success': 18, 'collisions': 28}, {'tx': 35, 'success': 15, 'collisions': 20}, {'tx': 63, 'success': 26, 'collisions': 37}, {'tx': 30, 'success': 13, 'collisions': 17}, {'tx': 33, 'success': 15, 'collisions': 18}, {'tx': 27, 'success': 9, 'collisions': 18}, {'tx': 67, 'success': 30, 'collisions': 37}]"
210,40,11,1371,512,859,0.6265499635302699,0.37345003646973013,0.5632,"[{'tx': 40, 'success': 15, 'collisions': 25}, {'tx': 7, 'success': 0, 'collisions': 7}, {'tx': 21, 'success': 7, 'collisions': 14}, {'tx': 45, 'success': 23, 'collisions': 22}, {'tx': 52, 'success': 21, 'collisions': 31}, {'tx': 56, 'success': 24, 'collisions': 32}, {'tx': 37, 'success': 14, 'collisions': 23}, {'tx': 7, 'success': 0, 'collisions': 7}, {'tx': 52, 'success': 22, 'collisions': 30}, {'tx': 46, 'success': 19, 'collisions': 27}, {'tx': 32, 'success': 12, 'collisions': 20}, {'tx': 37, 'success': 15, 'collisions': 22}, {'tx': 49, 'success': 21, 'collisions': 28}, {'tx': 71, 'success': 35, 'collisions': 36}, {'tx': 39, 'success': 15, 'collisions': 24}, {'tx': 10, 'success': 1, 'collisions': 9}, {'tx': 66, 'success': 29, 'collisions': 37}, {'tx': 20, 'success': 4, 'collisions': 16}, {'tx': 61, 'success': 24, 'collisions': 37}, {'tx': 33, 'success': 14, 'collisions': 19}, {'tx': 48, 'success': 17, 'collisions': 31}, {'tx': 64, 'success': 33, 'collisions': 31}, {'tx': 11, 'success': 1, 'collisions': 10}, {'tx': 29, 'success': 10, 'collisions': 19}, {'tx': 7, 'success': 0, 'collisions': 7}, {'tx': 12, 'success': 4, 'collisions': 8}, {'tx': 24, 'success': 5, 'collisions': 19}, {'tx': 36, 'success': 12, 'collisions': 24}, {'tx': 41, 'success': 13, 'collisions': 28}, {'tx': 40, 'success': 17, 'collisions': 23}, {'tx': 38, 'success': 12, 'collisions': 26}, {'tx': 37, 'success': 12, 'collisions': 25}, {'tx': 21, 'success': 6, 'collisions': 15}, {'tx': 33, 'success': 9, 'collisions': 24}, {'tx': 32, 'success': 9, 'collisions': 23}, {'tx': 15, 'success': 6, 'collisions': 9}, {'tx': 31, 'success': 9, 'collisions': 22}, {'tx': 7, 'success': 0, 'collisions': 7}, {'tx': 24, 'success': 7, 'collisions': 17}, {'tx': 40, 'success': 15, 'collisions': 25}]"
211,40,12,1244,483,761,0.6117363344051447,0.3882636655948553,0.5796,"[{'tx': 44, 'success': 21, 'collisions': 23}, {'tx': 6, 'success': 0, 'collisions': 6}, {'tx': 28, 'success': 8, 'collisions': 20}, {'tx': 20, 'success': 4, 'collisions': 16}, {'tx': 50, 'success': 21, 'collisions': 29}, {'tx': 30, 'success': 9, 'collisions': 21}, {'tx': 67, 'success': 34, 'collisions': 33}, {'tx': 15, 'success': 3, 'collisions': 12}, {'tx': 34, 'success': 14, 'collisions': 20}, {'tx': 13, 'success': 3, 'collisions': 10}, {'tx': 34, 'success': 10, 'collisions': 24}, {'tx': 17, 'success': 3, 'collisions': 14}, {'tx': 44, 'success': 19, 'collisions': 25}, {'tx': 60, 'success': 30, 'collisions': 30}, {'tx': 29, 'success': 9, 'collisions': 20}, {'tx': 59, 'success': 29, 'collisions': 30}, {'tx': 13, 'success': 3, 'collisions': 10}, {'tx': 43, 'success': 19, 'collisions': 24}, {'tx': 50, 'success': 23, 'collisions': 27}, {'tx': 34, 'success': 13, 'collisions': 21}, {'tx': 75, 'success': 42, 'collisions': 33}, {'tx': 22, 'success': 5, 'collisions': 17}, {'tx': 16, 'success': 3, 'collisions': 13}, {'tx': 6, 'success': 0, 'collisions': 6}, {'tx': 20, 'success': 6, 'collisions': 14}, {'tx': 31, 'success': 11, 'collisions': 20}, {'tx': 8, 'success': 0, 'collisions': 8}, {'tx': 6, 'success': 0, 'collisions': 6}, {'tx': 27, 'success': 8, 'collisions': 19}, {'tx': 63, 'success': 31, 'collisions': 32}, {'tx': 7, 'success': 0, 'collisions': 7}, {'tx': 34, 'success': 14, 'collisions': 20}, {'tx': 16, 'success': 4, 'collisions': 12}, {'tx': 51, 'success': 21, 'collisions': 30}, {'tx': 53, 'success': 23, 'collisions': 30}, {'tx': 26, 'success': 8, 'collisions': 18}, {'tx': 27, 'success': 10, 'collisions': 17}, {'tx': 39, 'success': 17, 'collisions': 22}, {'tx': 7, 'success': 0, 'collisions': 7}, {'tx': 20, 'success': 5, 'collisions': 15}]"
212,40,13,1176,431,745,0.6335034013605442,0.3664965986394558,0.5603,"[{'tx': 39, 'success': 11, 'collisions': 28}, {'tx': 14, 'success': 2, 'collisions': 12}, {'tx': 13, 'success': 1, 'collisions': 12}, {'tx': 35, 'success': 14, 'collisions': 21}, {'tx': 46, 'success': 22, 'collisions': 24}, {'tx': 20, 'success': 5, 'collisions': 15}, {'tx': 35, 'success': 12, 'collisions': 23}, {'tx': 10, 'success': 2, 'collisions': 8}, {'tx': 51, 'success': 23, 'collisions': 28}, {'tx': 15, 'success': 2, 'collisions': 13}, {'tx': 7, 'success': 0, 'collisions': 7}, {'tx': 8, 'success': 0, 'collisions': 8}, {'tx': 29, 'success': 8, 'collisions': 21}, {'tx': 54, 'success': 25, 'collisions': 29}, {'tx': 22, 'success': 10, 'collisions': 12}, {'tx': 35, 'success': 20, 'collisions': 15}, {'tx': 30, 'success': 8, 'collisions': 22}, {'tx': 27, 'success': 7, 'collisions': 20}, {'tx': 32, 'success': 13, 'collisions': 19}, {'tx': 56, 'success': 24, 'collisions': 32}, {'tx': 22, 'success': 8, 'collisions': 14}, {'tx': 7, 'success': 0, 'collisions': 7}, {'tx': 31, 'success': 9, 'collisions': 22}, {'tx': 56, 'success': 30, 'collisions': 26}, {'tx': 67, 'success': 33, 'collisions': 34}, {'tx': 38, 'success': 14, 'collisions': 24}, {'tx': 11, 'success': 1, 'collisions': 10}, {'tx': 13, 'success': 3, 'collisions': 10}, {'tx': 47, 'success': 19, 'collisions': 28}, {'tx': 65, 'success': 31, 'collisions': 34}, {'tx': 28, 'success': 9, 'collisions': 19}, {'tx': 16, 'success': 3, 'collisions': 13}, {'tx': 57, 'success': 24, 'collisions': 33}, {'tx': 17, 'success': 4, 'collisions': 13}, {'tx': 27, 'success': 7, 'collisions': 20}, {'tx': 27, 'success': 8, 'collisions': 19}, {'tx': 13, 'success': 3, 'collisions': 10}, {'tx': 22, 'success': 7, 'collisions': 15}, {'tx': 13, 'success': 2, 'collisions': 11}, {'tx': 21, 'success': 7, 'collisions': 14}]"
213,40,14,1088,401,687,0.6314338235294118,0.36856617647058826,0.5614,"[{'tx': 25, 'success': 7, 'collisions': 18}, {'tx': 27, 'success': 8, 'collisions': 19}, {'tx': 7, 'success': 0, 'collisions': 7}, {'tx': 15, 'success': 3, 'collisions': 12}, {'tx': 6, 'success': 0, 'collisions': 6}, {'tx': 21, 'success': 7, 'collisions': 14}, {'tx': 39, 'success': 15, 'collisions': 24}, {'tx': 31, 'success': 13, 'collisions': 18}, {'tx': 40, 'success': 16, 'collisions': 24}, {'tx': 14, 'success': 2, 'collisions': 12}, {'tx': 10, 'success': 2, 'collisions': 8}, {'tx': 11, 'success': 1, 'collisions': 10}, {'tx': 14, 'success': 3, 'collisions': 11}, {'tx': 55, 'success': 24, 'collisions': 31}, {'tx': 16, 'success': 3, 'collisions': 13}, {'tx': 41, 'success': 17, 'collisions': 24}, {'tx': 27, 'success': 9, 'collisions': 18}, {'tx': 7, 'success': 0, 'collisions': 7}, {'tx': 32, 'success': 10, 'collisions': 22}, {'tx': 7, 'success': 0, 'collisions': 7}, {'tx': 42, 'success': 21, 'collisions': 21}, {'tx': 21, 'success': 5, 'collisions': 16}, {'tx': 25, 'success': 8, 'collisions': 17}, {'tx': 42, 'success': 19, 'collisions': 23}, {'tx': 69, 'success': 34, 'collisions': 35}, {'tx': 25, 'success': 7, 'collisions': 18}, {'tx': 9, 'success': 1, 'collisions': 8}, {'tx': 19, 'success': 9, 'collisions': 10}, {'tx': 28, 'success': 7, 'collisions': 21}, {'tx': 25, 'success': 6, 'collisions': 19}, {'tx': 19, 'success': 5, 'collisions': 14}, {'tx': 51, 'success': 22, 'collisions': 29}, {'tx': 6, 'success': 0, 'collisions': 6}, {'tx': 48, 'success': 22, 'collisions': 26}, {'tx': 44, 'success': 20, 'collisions': 24}, {'tx': 69, 'success': 34, 'collisions': 35}, {'tx': 7, 'success': 0, 'collisions': 7}, {'tx': 52, 'success': 24, 'collisions': 28}, {'tx': 23, 'success': 10, 'collisions': 13}, {'tx': 19, 'success': 7, 'collisions': 12}]"
214,40,15,1033,388,645,0.6243949661181026,0.37560503388189737,0.582,"[{'tx': 30, 'success': 12, 'collisions': 18}, {'tx': 45, 'success': 18, 'collisions': 27}, {'tx': 39, 'success': 16, 'collisions': 23}, {'tx': 31, 'success': 15, 'collisions': 16}, {'tx': 31, 'success': 9, 'collisions': 22}, {'tx': 22, 'success': 8, 'collisions': 14}, {'tx': 6, 'success': 0, 'collisions': 6}, {'tx': 24, 'success': 8, 'collisions': 16}, {'tx': 19, 'success': 6, 'collisions': 13}, {'tx': 41, 'success': 19, 'collisions': 22}, {'tx': 40, 'success': 18, 'collisions': 22}, {'tx': 30, 'success': 12, 'collisions': 18}, {'tx': 10, 'success': 1, 'collisions': 9}, {'tx': 21, 'success': 5, 'collisions': 16}, {'tx': 10, 'success': 2, 'collisions': 8}, {'tx': 22, 'success': 8, 'collisions': 14}, {'tx': 33, 'success': 15, 'collisions': 18}, {'tx': 33, 'success': 12, 'collisions': 21}, {'tx': 15, 'success': 2, 'collisions': 13}, {'tx': 6, 'success': 0, 'collisions': 6}, {'tx': 29, 'success': 15, 'collisions': 14}, {'tx': 45, 'success': 19, 'collisions': 26}, {'tx': 21, 'success': 10, 'collisions': 11}, {'tx': 15, 'success': 2, 'collisions': 13}, {'tx': 41, 'success': 16, 'collisions': 25}, {'tx': 18, 'success': 3, 'collisions': 15}, {'tx': 6, 'success': 0, 'collisions': 6}, {'tx': 19, 'success': 5, 'collisions': 14}, {'tx': 12, 'success': 2, 'collisions': 10}, {'tx': 27, 'success': 7, 'collisions': 20}, {'tx': 16, 'success': 3, 'collisions': 13}, {'tx': 46, 'success': 22, 'collisions': 24}, {'tx': 10, 'success': 3, 'collisions': 7}, {'tx': 27, 'success': 10, 'collisions': 17}, {'tx': 25, 'success': 11, 'collisions': 14}, {'tx': 21, 'success': 7, 'collisions': 14}, {'tx': 16, 'success': 5, 'collisions': 11}, {'tx': 44, 'success': 18, 'collisions': 26}, {'tx': 49, 'success': 26, 'collisions': 23}, {'tx': 38, 'success': 18, 'collisions': 20}]"
215,40,16,951,361,590,0.6203995793901157,0.37960042060988436,0.5776,"[{'tx': 32, 'success': 11, 'collisions': 21}, {'tx': 15, 'success': 3, 'collisions': 12}, {'tx': 9, 'success': 1, 'collisions': 8}, {'tx': 28, 'success': 12, 'collisions': 16}, {'tx': 6, 'success': 0, 'collisions': 6}, {'tx': 39, 'success': 17, 'collisions': 22}, {'tx': 22, 'success': 6, 'collisions': 16}, {'tx': 9, 'success': 1, 'collisions': 8}, {'tx': 25, 'success': 8, 'collisions': 17}, {'tx': 16, 'success': 3, 'collisions': 13}, {'tx': 33, 'success': 15, 'collisions': 18}, {'tx': 12, 'success': 1, 'collisions': 11}, {'tx': 26, 'success': 12, 'collisions': 14}, {'tx': 7, 'success': 0, 'collisions': 7}, {'tx': 38, 'success': 18, 'collisions': 20}, {'tx': 36, 'success': 15, 'collisions': 21}, {'tx': 32, 'success': 16, 'collisions': 16}, {'tx': 24, 'success': 6, 'collisions': 18}, {'tx': 13, 'success': 3, 'collisions': 10}, {'tx': 26, 'success': 12, 'collisions': 14}, {'tx': 55, 'success': 27, 'collisions': 28}, {'tx': 6, 'success': 0, 'collisions': 6}, {'tx': 45, 'success': 21, 'collisions': 24}, {'tx': 10, 'success': 1, 'collisions': 9}, {'tx': 25, 'success': 9, 'collisions': 16}, {'tx': 17, 'success': 5, 'collisions': 12}, {'tx': 30, 'success': 11, 'collisions': 19}, {'tx': 35, 'success': 15, 'collisions': 20}, {'tx': 17, 'success': 8, 'collisions': 9}, {'tx': 16, 'success': 6, 'collisions': 10}, {'tx': 7, 'success': 0, 'collisions': 7}, {'tx': 21, 'success': 6, 'collisions': 15}, {'tx': 45, 'success': 23, 'collisions': 22}, {'tx': 7, 'success': 0, 'collisions': 7}, {'tx': 7, 'success': 0, 'collisions': 7}, {'tx': 12, 'success': 3, 'collisions': 9}, {'tx': 52, 'success': 30, 'collisions': 22}, {'tx': 41, 'success': 17, 'collisions': 24}, {'tx': 20, 'success': 7, 'collisions': 13}, {'tx': 35, 'success': 12, 'collisions': 23}]"
216,40,17,918,324,594,0.6470588235294118,0.35294117647058826,0.5508,"[{'tx': 21, 'success': 5, 'collisions': 16}, {'tx': 23, 'success': 10, 'collisions': 13}, {'tx': 9, 'success': 1, 'collisions': 8}, {'tx': 24, 'success': 8, 'collisions': 16}, {'tx': 15, 'success': 3, 'collisions': 12}, {'tx': 35, 'success': 14, 'collisions': 21}, {'tx': 45, 'success': 18, 'collisions': 27}, {'tx': 12, 'success': 2, 'collisions': 10}, {'tx': 17, 'success': 4, 'collisions': 13}, {'tx': 15, 'success': 3, 'collisions': 12}, {'tx': 14, 'success': 3, 'collisions': 11}, {'tx': 21, 'success': 6, 'collisions': 15}, {'tx': 42, 'success': 20, 'collisions': 22}, {'tx': 14, 'success': 4, 'collisions': 10}, {'tx': 29, 'success': 13, 'collisions': 16}, {'tx': 11, 'success': 2, 'collisions': 9}, {'tx': 41, 'success': 18, 'collisions': 23}, {'tx': 23, 'success': 9, 'collisions': 14}, {'tx': 25, 'success': 9, 'collisions': 16}, {'tx': 12, 'success': 2, 'collisions': 10}, {'tx': 17, 'success': 6, 'collisions': 11}, {'tx': 6, 'success': 0, 'collisions': 6}, {'tx': 27, 'success': 10, 'collisions': 17}, {'tx': 31, 'success': 12, 'collisions': 19}, {'tx': 24, 'success': 8, 'collisions': 16}, {'tx': 13, 'success': 2, 'collisions': 11}, {'tx': 38, 'success': 14, 'collisions': 24}, {'tx': 10, 'success': 2, 'collisions': 8}, {'tx': 40, 'success': 20, 'collisions': 20}, {'tx': 7, 'success': 1, 'collisions': 6}, {'tx': 40, 'success': 17, 'collisions': 23}, {'tx': 39, 'success': 18, 'collisions': 21}, {'tx': 26, 'success': 9, 'collisions': 17}, {'tx': 13, 'success': 3, 'collisions': 10}, {'tx': 13, 'success': 2, 'collisions': 11}, {'tx': 8, 'success': 1, 'collisions': 7}, {'tx': 6, 'success': 0, 'collisions': 6}, {'tx': 51, 'success': 23, 'collisions': 28}, {'tx': 43, 'success': 18, 'collisions': 25}, {'tx': 18, 'success': 4, 'collisions': 14}]"
217,40,18,869,312,557,0.6409666283084005,0.35903337169159955,0.5616,"[{'tx': 39, 'success': 20, 'collisions': 19}, {'tx': 23, 'success': 10, 'collisions': 13}, {'tx': 21, 'success': 7, 'collisions': 14}, {'tx': 35, 'success': 13, 'collisions': 22}, {'tx': 6, 'success': 0, 'collisions': 6}, {'tx': 10, 'success': 2, 'collisions': 8}, {'tx': 23, 'success': 6, 'collisions': 17}, {'tx': 13, 'success': 4, 'collisions': 9}, {'tx': 6, 'success': 0, 'collisions': 6}, {'tx': 6, 'success': 0, 'collisions': 6}, {'tx': 20, 'success': 9, 'collisions': 11}, {'tx': 20, 'success': 8, 'collisions': 12}, {'tx': 30, 'success': 10, 'collisions': 20}, {'tx': 43, 'success': 22, 'collisions': 21}, {'tx': 17, 'success': 6, 'collisions': 11}, {'tx': 33, 'success': 14, 'collisions': 19}, {'tx': 18, 'success': 4, 'collisions': 14}, {'tx': 33, 'success': 16, 'collisions': 17}, {'tx': 42, 'success': 21, 'collisions': 21}, {'tx': 6, 'success': 0, 'collisions': 6}, {'tx': 16, 'success': 3, 'collisions': 13}, {'tx': 27, 'success': 11, 'collisions': 16}, {'tx': 34, 'success': 13, 'collisions': 21}, {'tx': 10, 'success': 2, 'collisions': 8}, {'tx': 24, 'success': 6, 'collisions': 18}, {'tx': 11, 'success': 1, 'collisions': 10}, {'tx': 31, 'success': 11, 'collisions': 20}, {'tx': 8, 'success': 2, 'collisions': 6}, {'tx': 25, 'success': 6, 'collisions': 19}, {'tx': 44, 'success': 20, 'collisions': 24}, {'tx': 39, 'success': 16, 'collisions': 23}, {'tx': 7, 'success': 0, 'collisions': 7}, {'tx': 27, 'success': 10, 'collisions': 17}, {'tx': 13, 'success': 4, 'collisions': 9}, {'tx': 20, 'success': 5, 'collisions': 15}, {'tx': 21, 'success': 9, 'collisions': 12}, {'tx': 6, 'success': 0, 'collisions': 6}, {'tx': 12, 'success': 2, 'collisions': 10}, {'tx': 11, 'success': 2, 'collisions': 9}, {'tx': 39, 'success': 17, 'collisions': 22}]"
218,40,19,819,303,516,0.63003663003663,0.36996336996337,0.5757,"[{'tx': 6, 'success': 0, 'collisions': 6}, {'tx': 11, 'success': 2, 'collisions': 9}, {'tx': 34, 'success': 16, 'collisions': 18}, {'tx': 6, 'success': 0, 'collisions': 6}, {'tx': 14, 'success': 5, 'collisions': 9}, {'tx': 17, 'success': 4, 'collisions': 13}, {'tx': 31, 'success': 13, 'collisions': 18}, {'tx': 41, 'success': 21, 'collisions': 20}, {'tx': 31, 'success': 13, 'collisions': 18}, {'tx': 38, 'success': 15, 'collisions': 23}, {'tx': 29, 'success': 9, 'collisions': 20}, {'tx': 16, 'success': 4, 'collisions': 12}, {'tx': 6, 'success': 0, 'collisions': 6}, {'tx': 16, 'success': 5, 'collisions': 11}, {'tx': 12, 'success': 3, 'collisions': 9}, {'tx': 6, 'success': 0, 'collisions': 6}, {'tx': 20, 'success': 6, 'collisions': 14}, {'tx': 5, 'success': 0, 'collisions': 5}, {'tx': 24, 'success': 9, 'collisions': 15}, {'tx': 6, 'success': 0, 'collisions': 6}, {'tx': 24, 'success': 7, 'collisions': 17}, {'tx': 29, 'success': 11, 'collisions': 18}, {'tx': 5, 'success': 0, 'collisions': 5}, {'tx': 25, 'success': 11, 'collisions': 14}, {'tx': 24, 'success': 10, 'collisions': 14}, {'tx': 35, 'success': 17, 'collisions': 18}, {'tx': 9, 'success': 1, 'collisions': 8}, {'tx': 18, 'success': 5, 'collisions': 13}, {'tx': 6, 'success': 0, 'collisions': 6}, {'tx': 18, 'success': 7, 'collisions': 11}, {'tx': 43, 'success': 23, 'collisions': 20}, {'tx': 30, 'success': 12, 'collisions': 18}, {'tx': 22, 'success': 12, 'collisions': 10}, {'tx': 6, 'success': 0, 'collisions': 6}, {'tx': 24, 'success': 11, 'collisions': 13}, {'tx': 29, 'success': 10, 'collisions': 19}, {'tx': 17, 'success': 6, 'collisions': 11}, {'tx': 30, 'success': 13, 'collisions': 17}, {'tx': 14, 'success': 2, 'collisions': 12}, {'tx': 42, 'success': 20, 'collisions': 22}]"
219,40,20,804,271,533,0.6629353233830846,0.3370646766169154,0.542,"[{'tx': 16, 'success': 4, 'collisions': 12}, {'tx': 32, 'success': 16, 'collisions': 16}, {'tx': 10, 'success': 2, 'collisions': 8}, {'tx': 36, 'success': 17, 'collisions': 19}, {'tx': 20, 'success': 7, 'collisions': 13}, {'tx': 14, 'success': 4, 'collisions': 10}, {'tx': 18, 'success': 5, 'collisions': 13}, {'tx': 16, 'success': 4, 'collisions': 12}, {'tx': 34, 'success': 14, 'collisions': 20}, {'tx': 8, 'success': 1, 'collisions': 7}, {'tx': 21, 'success': 5, 'collisions': 16}, {'tx': 15, 'success': 3, 'collisions': 12}, {'tx': 19, 'success': 6, 'collisions': 13}, {'tx': 12, 'success': 3, 'collisions': 9}, {'tx': 36, 'success': 16, 'collisions': 20}, {'tx': 15, 'success': 3, 'collisions': 12}, {'tx': 39, 'success': 19, 'collisions': 20}, {'tx': 22, 'success': 9, 'collisions': 13}, {'tx': 19, 'success': 5, 'collisions': 14}, {'tx': 10, 'success': 1, 'collisions': 9}, {'tx': 14, 'success': 4, 'collisions': 10}, {'tx': 10, 'success': 2, 'collisions': 8}, {'tx': 40, 'success': 16, 'collisions': 24}, {'tx': 9, 'success': 1, 'collisions': 8}, {'tx': 36, 'success': 16, 'collisions': 20}, {'tx': 14, 'success': 5, 'collisions': 9}, {'tx': 22, 'success': 6, 'collisions': 16}, {'tx': 28, 'success': 10, 'collisions': 18}, {'tx': 34, 'success': 15, 'collisions': 19}, {'tx': 14, 'success': 2, 'collisions': 12}, {'tx': 6, 'success': 0, 'collisions': 6}, {'tx': 9, 'success': 1, 'collisions': 8}, {'tx': 20, 'success': 5, 'collisions': 15}, {'tx': 14, 'success': 5, 'collisions': 9}, {'tx': 17, 'success': 4, 'collisions': 13}, {'tx': 19, 'success': 7, 'collisions': 12}, {'tx': 17, 'success': 4, 'collisions': 13}, {'tx': 17, 'success': 4, 'collisions': 13}, {'tx': 26, 'success': 10, 'collisions': 16}, {'tx': 26, 'success': 10, 'collisions': 16}]"
220,40,21,759,257,502,0.6613965744400527,0.3386034255599473,0.5397,"[{'tx': 34, 'success': 14, 'collisions': 20}, {'tx': 18, 'success': 4, 'collisions': 14}, {'tx': 10, 'success': 1, 'collisions': 9}, {'tx': 6, 'success': 0, 'collisions': 6}, {'tx': 22, 'success': 8, 'collisions': 14}, {'tx': 29, 'success': 11, 'collisions': 18}, {'tx': 11, 'success': 2, 'collisions': 9}, {'tx': 22, 'success': 7, 'collisions': 15}, {'tx': 6, 'success': 0, 'collisions': 6}, {'tx': 8, 'success': 1, 'collisions': 7}, {'tx': 10, 'success': 2, 'collisions': 8}, {'tx': 35, 'success': 14, 'collisions': 21}, {'tx': 6, 'success': 0, 'collisions': 6}, {'tx': 38, 'success': 19, 'collisions': 19}, {'tx': 19, 'success': 5, 'collisions': 14}, {'tx': 38, 'success': 18, 'collisions': 20}, {'tx': 20, 'success': 8, 'collisions': 12}, {'tx': 20, 'success': 8, 'collisions': 12}, {'tx': 10, 'success': 1, 'collisions': 9}, {'tx': 14, 'success': 4, 'collisions': 10}, {'tx': 10, 'success': 2, 'collisions': 8}, {'tx': 39, 'success': 12, 'collisions': 27}, {'tx': 31, 'success': 11, 'collisions': 20}, {'tx': 19, 'success': 5, 'collisions': 14}, {'tx': 23, 'success': 9, 'collisions': 14}, {'tx': 21, 'success': 7, 'collisions': 14}, {'tx': 19, 'success': 5, 'collisions': 14}, {'tx': 29, 'success': 10, 'collisions': 19}, {'tx': 6, 'success': 0, 'collisions': 6}, {'tx': 5, 'success': 0, 'collisions': 5}, {'tx': 6, 'success': 0, 'collisions': 6}, {'tx': 27, 'success': 11, 'collisions': 16}, {'tx': 6, 'success': 0, 'collisions': 6}, {'tx': 17, 'success': 4, 'collisions': 13}, {'tx': 18, 'success': 7, 'collisions': 11}, {'tx': 19, 'success': 9, 'collisions': 10}, {'tx': 30, 'success': 14, 'collisions': 16}, {'tx': 14, 'success': 4, 'collisions': 10}, {'tx': 8, 'success': 1, 'collisions': 7}, {'tx': 36, 'success': 19, 'collisions': 17}]"
221,40,22,735,251,484,0.6585034013605442,0.3414965986394558,0.5522,"[{'tx': 11, 'success': 2, 'collisions': 9}, {'tx': 27, 'success': 12, 'collisions': 15}, {'tx': 6, 'success': 0, 'collisions': 6}, {'tx': 6, 'success': 0, 'collisions': 6}, {'tx': 47, 'success': 21, 'collisions': 26}, {'tx': 23, 'success': 6, 'collisions': 17}, {'tx': 12, 'success': 1, 'collisions': 11}, {'tx': 12, 'success': 2, 'collisions': 10}, {'tx': 25, 'success': 11, 'collisions': 14}, {'tx': 24, 'success': 11, 'collisions': 13}, {'tx': 25, 'success': 11, 'collisions': 14}, {'tx': 17, 'success': 5, 'collisions': 12}, {'tx': 14, 'success': 4, 'collisions': 10}, {'tx': 9, 'success': 1, 'collisions': 8}, {'tx': 18, 'success': 5, 'collisions': 13}, {'tx': 13, 'success': 2, 'collisions': 11}, {'tx': 6, 'success': 0, 'collisions': 6}, {'tx': 34, 'success': 15, 'collisions': 19}, {'tx': 6, 'success': 0, 'collisions': 6}, {'tx': 24, 'success': 7, 'collisions': 17}, {'tx': 17, 'success': 3, 'collisions': 14}, {'tx': 16, 'success': 6, 'collisions': 10}, {'tx': 6, 'success': 0, 'collisions': 6}, {'tx': 25, 'success': 10, 'collisions': 15}, {'tx': 25, 'success': 11, 'collisions': 14}, {'tx': 12, 'success': 3, 'collisions': 9}, {'tx': 37, 'success': 16, 'collisions': 21}, {'tx': 18, 'success': 5, 'collisions': 13}, {'tx': 7, 'success': 1, 'collisions': 6}, {'tx': 36, 'success': 17, 'collisions': 19}, {'tx': 6, 'success': 0, 'collisions': 6}, {'tx': 6, 'success': 0, 'collisions': 6}, {'tx': 6, 'success': 0, 'collisions': 6}, {'tx': 25, 'success': 10, 'collisions': 15}, {'tx': 16, 'success': 4, 'collisions': 12}, {'tx': 20, 'success': 10, 'collisions': 10}, {'tx': 31, 'success': 13, 'collisions': 18}, {'tx': 29, 'success': 13, 'collisions': 16}, {'tx': 12, 'success': 3, 'collisions': 9}, {'tx': 26, 'success': 10, 'collisions': 16}]"
222,40,23,697,239,458,0.6571018651362984,0.3428981348637016,0.5497,"[{'tx': 20, 'success': 8, 'collisions': 12}, {'tx': 30, 'success': 13, 'collisions': 17}, {'tx': 19, 'success': 6, 'collisions': 13}, {'tx': 11, 'success': 3, 'collisions': 8}, {'tx': 5, 'success': 0, 'collisions': 5}, {'tx': 15, 'success': 4, 'collisions': 11}, {'tx': 6, 'success': 0, 'collisions': 6}, {'tx': 39, 'success': 19, 'collisions': 20}, {'tx': 7, 'success': 0, 'collisions': 7}, {'tx': 17, 'success': 6, 'collisions': 11}, {'tx': 6, 'success': 0, 'collisions': 6}, {'tx': 36, 'success': 15, 'collisions': 21}, {'tx': 21, 'success': 6, 'collisions': 15}, {'tx': 35, 'success': 16, 'collisions': 19}, {'tx': 35, 'success': 18, 'collisions': 17}, {'tx': 6, 'success': 0, 'collisions': 6}, {'tx': 11, 'success': 2, 'collisions': 9}, {'tx': 6, 'success': 0, 'collisions': 6}, {'tx': 19, 'success': 7, 'collisions': 12}, {'tx': 25, 'success': 8, 'collisions': 17}, {'tx': 13, 'success': 3, 'collisions': 10}, {'tx': 5, 'success': 0, 'collisions': 5}, {'tx': 25, 'success': 8, 'collisions': 17}, {'tx': 36, 'success': 17, 'collisions': 19}, {'tx': 28, 'success': 14, 'collisions': 14}, {'tx': 21, 'success': 9, 'collisions': 12}, {'tx': 19, 'success': 6, 'collisions': 13}, {'tx': 17, 'success': 5, 'collisions': 12}, {'tx': 5, 'success': 0, 'collisions': 5}, {'tx': 20, 'success': 6, 'collisions': 14}, {'tx': 22, 'success': 8, 'collisions': 14}, {'tx': 9, 'success': 3, 'collisions': 6}, {'tx': 6, 'success': 0, 'collisions': 6}, {'tx': 24, 'success': 8, 'collisions': 16}, {'tx': 19, 'success': 9, 'collisions': 10}, {'tx': 17, 'success': 3, 'collisions': 14}, {'tx': 5, 'success': 0, 'collisions': 5}, {'tx': 7, 'success': 2, 'collisions': 5}, {'tx': 6, 'success': 0, 'collisions': 6}, {'tx': 24, 'success': 7, 'collisions': 17}]"
223,40,24,675,239,436,0.6459259259259259,0.3540740740740741,0.5736,"[{'tx': 13, 'success': 3, 'collisions': 10}, {'tx': 5, 'success': 0, 'collisions': 5}, {'tx': 32, 'success': 15, 'collisions': 17}, {'tx': 34, 'success': 18, 'collisions': 16}, {'tx': 18, 'success': 7, 'collisions': 11}, {'tx': 9, 'success': 1, 'collisions': 8}, {'tx': 18, 'success': 8, 'collisions': 10}, {'tx': 5, 'success': 0, 'collisions': 5}, {'tx': 17, 'success': 4, 'collisions': 13}, {'tx': 16, 'success': 4, 'collisions': 12}, {'tx': 21, 'success': 7, 'collisions': 14}, {'tx': 5, 'success': 0, 'collisions': 5}, {'tx': 7, 'success': 2, 'collisions': 5}, {'tx': 38, 'success': 17, 'collisions': 21}, {'tx': 18, 'success': 5, 'collisions': 13}, {'tx': 19, 'success': 5, 'collisions': 14}, {'tx': 15, 'success': 4, 'collisions': 11}, {'tx': 6, 'success': 0, 'collisions': 6}, {'tx': 26, 'success': 13, 'collisions': 13}, {'tx': 33, 'success': 15, 'collisions': 18}, {'tx': 25, 'success': 12, 'collisions': 13}, {'tx': 5, 'success': 0, 'collisions': 5}, {'tx': 6, 'success': 1, 'collisions': 5}, {'tx': 14, 'success': 3, 'collisions': 11}, {'tx': 22, 'success': 8, 'collisions': 14}, {'tx': 18, 'success': 7, 'collisions': 11}, {'tx': 35, 'success': 16, 'collisions': 19}, {'tx': 19, 'success': 5, 'collisions': 14}, {'tx': 13, 'success': 4, 'collisions': 9}, {'tx': 35, 'success': 23, 'collisions': 12}, {'tx': 13, 'success': 4, 'collisions': 9}, {'tx': 11, 'success': 1, 'collisions': 10}, {'tx': 5, 'success': 0, 'collisions': 5}, {'tx': 25, 'success': 9, 'collisions': 16}, {'tx': 18, 'success': 6, 'collisions': 12}, {'tx': 8, 'success': 1, 'collisions': 7}, {'tx': 6, 'success': 0, 'collisions': 6}, {'tx': 15, 'success': 5, 'collisions': 10}, {'tx': 17, 'success': 4, 'collisions': 13}, {'tx': 10, 'success': 2, 'collisions': 8}]"
224,40,25,653,217,436,0.667687595712098,0.332312404287902,0.5425,"[{'tx': 20, 'success': 9, 'collisions': 11}, {'tx': 21, 'success': 10, 'collisions': 11}, {'tx': 12, 'success': 2, 'collisions': 10}, {'tx': 18, 'success': 6, 'collisions': 12}, {'tx': 16, 'success': 5, 'collisions': 11}, {'tx': 19, 'success': 4, 'collisions': 15}, {'tx': 20, 'success': 7, 'collisions': 13}, {'tx': 26, 'success': 9, 'collisions': 17}, {'tx': 7, 'success': 1, 'collisions': 6}, {'tx': 18, 'success': 6, 'collisions': 12}, {'tx': 17, 'success': 4, 'collisions': 13}, {'tx': 37, 'success': 19, 'collisions': 18}, {'tx': 5, 'success': 0, 'collisions': 5}, {'tx': 21, 'success': 6, 'collisions': 15}, {'tx': 18, 'success': 5, 'collisions': 13}, {'tx': 18, 'success': 6, 'collisions': 12}, {'tx': 7, 'success': 0, 'collisions': 7}, {'tx': 7, 'success': 0, 'collisions': 7}, {'tx': 16, 'success': 4, 'collisions': 12}, {'tx': 21, 'success': 8, 'collisions': 13}, {'tx': 43, 'success': 22, 'collisions': 21}, {'tx': 9, 'success': 1, 'collisions': 8}, {'tx': 6, 'success': 0, 'collisions': 6}, {'tx': 6, 'success': 0, 'collisions': 6}, {'tx': 19, 'success': 7, 'collisions': 12}, {'tx': 29, 'success': 11, 'collisions': 18}, {'tx': 20, 'success': 10, 'collisions': 10}, {'tx': 12, 'success': 3, 'collisions': 9}, {'tx': 7, 'success': 0, 'collisions': 7}, {'tx': 20, 'success': 8, 'collisions': 12}, {'tx': 8, 'success': 1, 'collisions': 7}, {'tx': 21, 'success': 9, 'collisions': 12}, {'tx': 14, 'success': 4, 'collisions': 10}, {'tx': 5, 'success': 0, 'collisions': 5}, {'tx': 25, 'success': 12, 'collisions': 13}, {'tx': 27, 'success': 10, 'collisions': 17}, {'tx': 6, 'success': 0, 'collisions': 6}, {'tx': 9, 'success': 1, 'collisions': 8}, {'tx': 17, 'success': 7, 'collisions': 10}, {'tx': 6, 'success': 0, 'collisions': 6}]"
225,40,26,639,213,426,0.6666666666666666,0.3333333333333333,0.5538,"[{'tx': 38, 'success': 17, 'collisions': 21}, {'tx': 18, 'success': 6, 'collisions': 12}, {'tx': 24, 'success': 8, 'collisions': 16}, {'tx': 6, 'success': 0, 'collisions': 6}, {'tx': 5, 'success': 0, 'collisions': 5}, {'tx': 14, 'success': 3, 'collisions': 11}, {'tx': 13, 'success': 4, 'collisions': 9}, {'tx': 6, 'success': 0, 'collisions': 6}, {'tx': 21, 'success': 8, 'collisions': 13}, {'tx': 14, 'success': 4, 'collisions': 10}, {'tx': 10, 'success': 2, 'collisions': 8}, {'tx': 23, 'success': 10, 'collisions': 13}, {'tx': 20, 'success': 6, 'collisions': 14}, {'tx': 16, 'success': 5, 'collisions': 11}, {'tx': 23, 'success': 10, 'collisions': 13}, {'tx': 12, 'success': 3, 'collisions': 9}, {'tx': 22, 'success': 7, 'collisions': 15}, {'tx': 8, 'success': 1, 'collisions': 7}, {'tx': 14, 'success': 3, 'collisions': 11}, {'tx': 5, 'success': 0, 'collisions': 5}, {'tx': 5, 'success': 0, 'collisions': 5}, {'tx': 14, 'success': 3, 'collisions': 11}, {'tx': 24, 'success': 12, 'collisions': 12}, {'tx': 14, 'success': 6, 'collisions': 8}, {'tx': 11, 'success': 3, 'collisions': 8}, {'tx': 21, 'success': 9, 'collisions': 12}, {'tx': 23, 'success': 11, 'collisions': 12}, {'tx': 6, 'success': 0, 'collisions': 6}, {'tx': 15, 'success': 4, 'collisions': 11}, {'tx': 17, 'success': 8, 'collisions': 9}, {'tx': 5, 'success': 0, 'collisions': 5}, {'tx': 12, 'success': 3, 'collisions': 9}, {'tx': 19, 'success': 6, 'collisions': 13}, {'tx': 5, 'success': 0, 'collisions': 5}, {'tx': 43, 'success': 23, 'collisions': 20}, {'tx': 18, 'success': 5, 'collisions': 13}, {'tx': 19, 'success': 6, 'collisions': 13}, {'tx': 21, 'success': 7, 'collisions': 14}, {'tx': 10, 'success': 1, 'collisions': 9}, {'tx': 25, 'success': 9, 'collisions': 16}]"
226,40,27,629,195,434,0.6899841017488076,0.31001589825119236,0.5265,"[{'tx': 10, 'success': 1, 'collisions': 9}, {'tx': 6, 'success': 0, 'collisions': 6}, {'tx': 8, 'success': 1, 'collisions': 7}, {'tx': 9, 'success': 1, 'collisions': 8}, {'tx': 20, 'success': 6, 'collisions': 14}, {'tx': 11, 'success': 2, 'collisions': 9}, {'tx': 6, 'success': 0, 'collisions': 6}, {'tx': 7, 'success': 1, 'collisions': 6}, {'tx': 12, 'success': 2, 'collisions': 10}, {'tx': 13, 'success': 2, 'collisions': 11}, {'tx': 26, 'success': 11, 'collisions': 15}, {'tx': 15, 'success': 5, 'collisions': 10}, {'tx': 13, 'success': 3, 'collisions': 10}, {'tx': 12, 'success': 3, 'collisions': 9}, {'tx': 20, 'success': 6, 'collisions': 14}, {'tx': 21, 'success': 8, 'collisions': 13}, {'tx': 13, 'success': 2, 'collisions': 11}, {'tx': 15, 'success': 5, 'collisions': 10}, {'tx': 6, 'success': 0, 'collisions': 6}, {'tx': 22, 'success': 9, 'collisions': 13}, {'tx': 23, 'success': 11, 'collisions': 12}, {'tx': 14, 'success': 3, 'collisions': 11}, {'tx': 34, 'success': 16, 'collisions': 18}, {'tx': 21, 'success': 9, 'collisions': 12}, {'tx': 29, 'success': 11, 'collisions': 18}, {'tx': 10, 'success': 2, 'collisions': 8}, {'tx': 10, 'success': 1, 'collisions': 9}, {'tx': 19, 'success': 6, 'collisions': 13}, {'tx': 29, 'success': 11, 'collisions': 18}, {'tx': 20, 'success': 6, 'collisions': 14}, {'tx': 5, 'success': 0, 'collisions': 5}, {'tx': 16, 'success': 5, 'collisions': 11}, {'tx': 20, 'success': 9, 'collisions': 11}, {'tx': 19, 'success': 7, 'collisions': 12}, {'tx': 24, 'success': 11, 'collisions': 13}, {'tx': 14, 'success': 3, 'collisions': 11}, {'tx': 12, 'success': 3, 'collisions': 9}, {'tx': 16, 'success': 5, 'collisions': 11}, {'tx': 19, 'success': 6, 'collisions': 13}, {'tx': 10, 'success': 2, 'collisions': 8}]"
227,40,28,597,196,401,0.6716917922948074,0.32830820770519265,0.5488,"[{'tx': 17, 'success': 4, 'collisions': 13}, {'tx': 8, 'success': 1, 'collisions': 7}, {'tx': 17, 'success': 6, 'collisions': 11}, {'tx': 10, 'success': 2, 'collisions': 8}, {'tx': 13, 'success': 2, 'collisions': 11}, {'tx': 10, 'success': 2, 'collisions': 8}, {'tx': 12, 'success': 2, 'collisions': 10}, {'tx': 8, 'success': 1, 'collisions': 7}, {'tx': 7, 'success': 1, 'collisions': 6}, {'tx': 31, 'success': 15, 'collisions': 16}, {'tx': 5, 'success': 0, 'collisions': 5}, {'tx': 24, 'success': 12, 'collisions': 12}, {'tx': 12, 'success': 3, 'collisions': 9}, {'tx': 5, 'success': 0, 'collisions': 5}, {'tx': 28, 'success': 12, 'collisions': 16}, {'tx': 15, 'success': 4, 'collisions': 11}, {'tx': 10, 'success': 3, 'collisions': 7}, {'tx': 20, 'success': 8, 'collisions': 12}, {'tx': 11, 'success': 3, 'collisions': 8}, {'tx': 24, 'success': 12, 'collisions': 12}, {'tx': 5, 'success': 0, 'collisions': 5}, {'tx': 12, 'success': 3, 'collisions': 9}, {'tx': 11, 'success': 2, 'collisions': 9}, {'tx': 17, 'success': 5, 'collisions': 12}, {'tx': 26, 'success': 14, 'collisions': 12}, {'tx': 10, 'success': 3, 'collisions': 7}, {'tx': 5, 'success': 0, 'collisions': 5}, {'tx': 16, 'success': 6, 'collisions': 10}, {'tx': 14, 'success': 4, 'collisions': 10}, {'tx': 25, 'success': 10, 'collisions': 15}, {'tx': 13, 'success': 3, 'collisions': 10}, {'tx': 12, 'success': 2, 'collisions': 10}, {'tx': 30, 'success': 17, 'collisions': 13}, {'tx': 22, 'success': 5, 'collisions': 17}, {'tx': 23, 'success': 9, 'collisions': 14}, {'tx': 11, 'success': 2, 'collisions': 9}, {'tx': 18, 'success': 6, 'collisions': 12}, {'tx': 12, 'success': 2, 'collisions': 10}, {'tx': 20, 'success': 9, 'collisions': 11}, {'tx': 8, 'success': 1, 'collisions': 7}]"
228,40,29,578,187,391,0.6764705882352942,0.3235294117647059,0.5423,"[{'tx': 11, 'success': 3, 'collisions': 8}, {'tx': 9, 'success': 1, 'collisions': 8}, {'tx': 20, 'success': 8, 'collisions': 12}, {'tx': 25, 'success': 12, 'collisions': 13}, {'tx': 17, 'success': 5, 'collisions': 12}, {'tx': 6, 'success': 0, 'collisions': 6}, {'tx': 16, 'success': 6, 'collisions': 10}, {'tx': 11, 'success': 3, 'collisions': 8}, {'tx': 36, 'success': 21, 'collisions': 15}, {'tx': 6, 'success': 0, 'collisions': 6}, {'tx': 5, 'success': 0, 'collisions': 5}, {'tx': 13, 'success': 3, 'collisions': 10}, {'tx': 5, 'success': 0, 'collisions': 5}, {'tx': 6, 'success': 0, 'collisions': 6}, {'tx': 6, 'success': 0, 'collisions': 6}, {'tx': 12, 'success': 3, 'collisions': 9}, {'tx': 30, 'success': 16, 'collisions': 14}, {'tx': 5, 'success': 0, 'collisions': 5}, {'tx': 15, 'success': 4, 'collisions': 11}, {'tx': 14, 'success': 3, 'collisions': 11}, {'tx': 21, 'success': 10, 'collisions': 11}, {'tx': 5, 'success': 0, 'collisions': 5}, {'tx': 20, 'success': 6, 'collisions': 14}, {'tx': 16, 'success': 4, 'collisions': 12}, {'tx': 23, 'success': 10, 'collisions': 13}, {'tx': 25, 'success': 11, 'collisions': 14}, {'tx': 11, 'success': 2, 'collisions': 9}, {'tx': 16, 'success': 3, 'collisions': 13}, {'tx': 7, 'success': 1, 'collisions': 6}, {'tx': 8, 'success': 1, 'collisions': 7}, {'tx': 18, 'success': 8, 'collisions': 10}, {'tx': 15, 'success': 4, 'collisions': 11}, {'tx': 24, 'success': 8, 'collisions': 16}, {'tx': 9, 'success': 2, 'collisions': 7}, {'tx': 24, 'success': 11, 'collisions': 13}, {'tx': 10, 'success': 2, 'collisions': 8}, {'tx': 7, 'success': 1, 'collisions': 6}, {'tx': 27, 'success': 10, 'collisions': 17}, {'tx': 12, 'success': 3, 'collisions': 9}, {'tx': 12, 'success': 2, 'collisions': 10}]"
229,40,30,552,185,367,0.6648550724637681,0.3351449275362319,0.555,"[{'tx': 11, 'success': 3, 'collisions': 8}, {'tx': 9, 'success': 1, 'collisions': 8}, {'tx': 17, 'success': 6, 'collisions': 11}, {'tx': 16, 'success': 9, 'collisions': 7}, {'tx': 10, 'success': 2, 'collisions': 8}, {'tx': 15, 'success': 4, 'collisions': 11}, {'tx': 6, 'success': 0, 'collisions': 6}, {'tx': 19, 'success': 6, 'collisions': 13}, {'tx': 11, 'success': 3, 'collisions': 8}, {'tx': 28, 'success': 13, 'collisions': 15}, {'tx': 25, 'success': 10, 'collisions': 15}, {'tx': 6, 'success': 0, 'collisions': 6}, {'tx': 16, 'success': 6, 'collisions': 10}, {'tx': 22, 'success': 8, 'collisions': 14}, {'tx': 5, 'success': 0, 'collisions': 5}, {'tx': 6, 'success': 0, 'collisions': 6}, {'tx': 16, 'success': 7, 'collisions': 9}, {'tx': 19, 'success': 8, 'collisions': 11}, {'tx': 8, 'success': 1, 'collisions': 7}, {'tx': 24, 'success': 10, 'collisions': 14}, {'tx': 13, 'success': 6, 'collisions': 7}, {'tx': 11, 'success': 4, 'collisions': 7}, {'tx': 15, 'success': 5, 'collisions': 10}, {'tx': 11, 'success': 3, 'collisions': 8}, {'tx': 19, 'success': 8, 'collisions': 11}, {'tx': 17, 'success': 5, 'collisions': 12}, {'tx': 5, 'success': 0, 'collisions': 5}, {'tx': 8, 'success': 1, 'collisions': 7}, {'tx': 8, 'success': 1, 'collisions': 7}, {'tx': 11, 'success': 4, 'collisions': 7}, {'tx': 18, 'success': 6, 'collisions': 12}, {'tx': 16, 'success': 7, 'collisions': 9}, {'tx': 13, 'success': 3, 'collisions': 10}, {'tx': 5, 'success': 0, 'collisions': 5}, {'tx': 10, 'success': 2, 'collisions': 8}, {'tx': 5, 'success': 0, 'collisions': 5}, {'tx': 32, 'success': 16, 'collisions': 16}, {'tx': 19, 'success': 7, 'collisions': 12}, {'tx': 10, 'success': 3, 'collisions': 7}, {'tx': 17, 'success': 7, 'collisions': 10}]"
230,40,31,541,172,369,0.6820702402957486,0.3179297597042514,0.5332,"[{'tx': 5, 'success': 0, 'collisions': 5}, {'tx': 5, 'success': 0, 'collisions': 5}, {'tx': 17, 'success': 6, 'collisions': 11}, {'tx': 23, 'success': 12, 'collisions': 11}, {'tx': 5, 'success': 0, 'collisions': 5}, {'tx': 14, 'success': 7, 'collisions': 7}, {'tx': 6, 'success': 0, 'collisions': 6}, {'tx': 16, 'success': 4, 'collisions': 12}, {'tx': 10, 'success': 2, 'collisions': 8}, {'tx': 27, 'success': 13, 'collisions': 14}, {'tx': 11, 'success': 3, 'collisions': 8}, {'tx': 5, 'success': 0, 'collisions': 5}, {'tx': 21, 'success': 12, 'collisions': 9}, {'tx': 20, 'success': 7, 'collisions': 13}, {'tx': 15, 'success': 4, 'collisions': 11}, {'tx': 14, 'success': 3, 'collisions': 11}, {'tx': 14, 'success': 5, 'collisions': 9}, {'tx': 8, 'success': 1, 'collisions': 7}, {'tx': 20, 'success': 8, 'collisions': 12}, {'tx': 29, 'success': 12, 'collisions': 17}, {'tx': 15, 'success': 4, 'collisions': 11}, {'tx': 17, 'success': 4, 'collisions': 13}, {'tx': 8, 'success': 1, 'collisions': 7}, {'tx': 26, 'success': 10, 'collisions': 16}, {'tx': 7, 'success': 0, 'collisions': 7}, {'tx': 14, 'success': 5, 'collisions': 9}, {'tx': 14, 'success': 5, 'collisions': 9}, {'tx': 5, 'success': 0, 'collisions': 5}, {'tx': 12, 'success': 2, 'collisions': 10}, {'tx': 9, 'success': 1, 'collisions': 8}, {'tx': 26, 'success': 12, 'collisions': 14}, {'tx': 5, 'success': 0, 'collisions': 5}, {'tx': 13, 'success': 4, 'collisions': 9}, {'tx': 13, 'success': 4, 'collisions': 9}, {'tx': 5, 'success': 0, 'collisions': 5}, {'tx': 10, 'success': 1, 'collisions': 9}, {'tx': 30, 'success': 13, 'collisions': 17}, {'tx': 5, 'success': 0, 'collisions': 5}, {'tx': 17, 'success': 7, 'collisions': 10}, {'tx': 5, 'success': 0, 'collisions': 5}]"
231,40,32,527,169,358,0.6793168880455408,0.3206831119544592,0.5408,"[{'tx': 12, 'success': 5, 'collisions': 7}, {'tx': 26, 'success': 11, 'collisions': 15}, {'tx': 13, 'success': 5, 'collisions': 8}, {'tx': 19, 'success': 9, 'collisions': 10}, {'tx': 18, 'success': 6, 'collisions': 12}, {'tx': 5, 'success': 0, 'collisions': 5}, {'tx': 19, 'success': 6, 'collisions': 13}, {'tx': 17, 'success': 7, 'collisions': 10}, {'tx': 14, 'success': 4, 'collisions': 10}, {'tx': 19, 'success': 7, 'collisions': 12}, {'tx': 8, 'success': 1, 'collisions': 7}, {'tx': 16, 'success': 5, 'collisions': 11}, {'tx': 11, 'success': 3, 'collisions': 8}, {'tx': 27, 'success': 10, 'collisions': 17}, {'tx': 5, 'success': 0, 'collisions': 5}, {'tx': 10, 'success': 1, 'collisions': 9}, {'tx': 11, 'success': 3, 'collisions': 8}, {'tx': 6, 'success': 1, 'collisions': 5}, {'tx': 17, 'success': 7, 'collisions': 10}, {'tx': 20, 'success': 9, 'collisions': 11}, {'tx': 4, 'success': 0, 'collisions': 4}, {'tx': 10, 'success': 1, 'collisions': 9}, {'tx': 8, 'success': 2, 'collisions': 6}, {'tx': 9, 'success': 1, 'collisions': 8}, {'tx': 8, 'success': 1, 'collisions': 7}, {'tx': 6, 'success': 0, 'collisions': 6}, {'tx': 6, 'success': 0, 'collisions': 6}, {'tx': 5, 'success': 0, 'collisions': 5}, {'tx': 13, 'success': 4, 'collisions': 9}, {'tx': 13, 'success': 5, 'collisions': 8}, {'tx': 19, 'success': 8, 'collisions': 11}, {'tx': 10, 'success': 1, 'collisions': 9}, {'tx': 17, 'success': 8, 'collisions': 9}, {'tx': 22, 'success': 9, 'collisions': 13}, {'tx': 22, 'success': 8, 'collisions': 14}, {'tx': 21, 'success': 10, 'collisions': 11}, {'tx': 12, 'success': 4, 'collisions': 8}, {'tx': 7, 'success': 1, 'collisions': 6}, {'tx': 6, 'success': 0, 'collisions': 6}, {'tx': 16, 'success': 6, 'collisions': 10}]"
232,40,33,526,159,367,0.6977186311787072,0.30228136882129275,0.5247,"[{'tx': 11, 'success': 3, 'collisions': 8}, {'tx': 24, 'success': 10, 'collisions': 14}, {'tx': 9, 'success': 1, 'collisions': 8}, {'tx': 9, 'success': 1, 'collisions': 8}, {'tx': 14, 'success': 5, 'collisions': 9}, {'tx': 29, 'success': 13, 'collisions': 16}, {'tx': 6, 'success': 0, 'collisions': 6}, {'tx': 5, 'success': 0, 'collisions': 5}, {'tx': 5, 'success': 0, 'collisions': 5}, {'tx': 13, 'success': 4, 'collisions': 9}, {'tx': 5, 'success': 0, 'collisions': 5}, {'tx': 27, 'success': 14, 'collisions': 13}, {'tx': 12, 'success': 3, 'collisions': 9}, {'tx': 6, 'success': 0, 'collisions': 6}, {'tx': 6, 'success': 0, 'collisions': 6}, {'tx': 13, 'success': 3, 'collisions': 10}, {'tx': 6, 'success': 0, 'collisions': 6}, {'tx': 7, 'success': 1, 'collisions': 6}, {'tx': 26, 'success': 10, 'collisions': 16}, {'tx': 22, 'success': 8, 'collisions': 14}, {'tx': 12, 'success': 3, 'collisions': 9}, {'tx': 20, 'success': 7, 'collisions': 13}, {'tx': 12, 'success': 3, 'collisions': 9}, {'tx': 13, 'success': 6, 'collisions': 7}, {'tx': 5, 'success': 0, 'collisions': 5}, {'tx': 12, 'success': 2, 'collisions': 10}, {'tx': 25, 'success': 10, 'collisions': 15}, {'tx': 15, 'success': 4, 'collisions': 11}, {'tx': 10, 'success': 2, 'collisions': 8}, {'tx': 10, 'success': 1, 'collisions': 9}, {'tx': 5, 'success': 0, 'collisions': 5}, {'tx': 12, 'success': 3, 'collisions': 9}, {'tx': 11, 'success': 3, 'collisions': 8}, {'tx': 20, 'success': 9, 'collisions': 11}, {'tx': 24, 'success': 9, 'collisions': 15}, {'tx': 6, 'success': 0, 'collisions': 6}, {'tx': 16, 'success': 5, 'collisions': 11}, {'tx': 13, 'success': 4, 'collisions': 9}, {'tx': 24, 'success': 12, 'collisions': 12}, {'tx': 6, 'success': 0, 'collisions': 6}]"
233,40,34,496,153,343,0.6915322580645161,0.3084677419354839,0.5202,"[{'tx': 14, 'success': 2, 'collisions': 12}, {'tx': 5, 'success': 0, 'collisions': 5}, {'tx': 13, 'success': 3, 'collisions': 10}, {'tx': 5, 'success': 0, 'collisions': 5}, {'tx': 22, 'success': 10, 'collisions': 12}, {'tx': 8, 'success': 4, 'collisions': 4}, {'tx': 16, 'success': 5, 'collisions': 11}, {'tx': 16, 'success': 5, 'collisions': 11}, {'tx': 6, 'success': 0, 'collisions': 6}, {'tx': 10, 'success': 3, 'collisions': 7}, {'tx': 20, 'success': 7, 'collisions': 13}, {'tx': 8, 'success': 1, 'collisions': 7}, {'tx': 6, 'success': 0, 'collisions': 6}, {'tx': 18, 'success': 7, 'collisions': 11}, {'tx': 11, 'success': 3, 'collisions': 8}, {'tx': 15, 'success': 6, 'collisions': 9}, {'tx': 5, 'success': 0, 'collisions': 5}, {'tx': 17, 'success': 5, 'collisions': 12}, {'tx': 33, 'success': 15, 'collisions': 18}, {'tx': 15, 'success': 7, 'collisions': 8}, {'tx': 33, 'success': 17, 'collisions': 16}, {'tx': 5, 'success': 0, 'collisions': 5}, {'tx': 5, 'success': 0, 'collisions': 5}, {'tx': 18, 'success': 6, 'collisions': 12}, {'tx': 16, 'success': 6, 'collisions': 10}, {'tx': 5, 'success': 0, 'collisions': 5}, {'tx': 11, 'success': 2, 'collisions': 9}, {'tx': 14, 'success': 4, 'collisions': 10}, {'tx': 11, 'success': 5, 'collisions': 6}, {'tx': 5, 'success': 0, 'collisions': 5}, {'tx': 14, 'success': 4, 'collisions': 10}, {'tx': 5, 'success': 0, 'collisions': 5}, {'tx': 9, 'success': 2, 'collisions': 7}, {'tx': 12, 'success': 3, 'collisions': 9}, {'tx': 5, 'success': 0, 'collisions': 5}, {'tx': 9, 'success': 1, 'collisions': 8}, {'tx': 16, 'success': 5, 'collisions': 11}, {'tx': 15, 'success': 6, 'collisions': 9}, {'tx': 18, 'success': 8, 'collisions': 10}, {'tx': 7, 'success': 1, 'collisions': 6}]"
234,40,35,486,147,339,0.6975308641975309,0.30246913580246915,0.5145,"[{'tx': 23, 'success': 12, 'collisions': 11}, {'tx': 5, 'success': 0, 'collisions': 5}, {'tx': 10, 'success': 3, 'collisions': 7}, {'tx': 24, 'success': 9, 'collisions': 15}, {'tx': 11, 'success': 3, 'collisions': 8}, {'tx': 10, 'success': 3, 'collisions': 7}, {'tx': 5, 'success': 0, 'collisions': 5}, {'tx': 18, 'success': 7, 'collisions': 11}, {'tx': 6, 'success': 0, 'collisions': 6}, {'tx': 6, 'success': 0, 'collisions': 6}, {'tx': 5, 'success': 0, 'collisions': 5}, {'tx': 9, 'success': 2, 'collisions': 7}, {'tx': 11, 'success': 3, 'collisions': 8}, {'tx': 5, 'success': 0, 'collisions': 5}, {'tx': 20, 'success': 10, 'collisions': 10}, {'tx': 5, 'success': 0, 'collisions': 5}, {'tx': 5, 'success': 0, 'collisions': 5}, {'tx': 16, 'success': 4, 'collisions': 12}, {'tx': 25, 'success': 14, 'collisions': 11}, {'tx': 5, 'success': 0, 'collisions': 5}, {'tx': 18, 'success': 7, 'collisions': 11}, {'tx': 6, 'success': 0, 'collisions': 6}, {'tx': 9, 'success': 1, 'collisions': 8}, {'tx': 13, 'success': 5, 'collisions': 8}, {'tx': 6, 'success': 0, 'collisions': 6}, {'tx': 12, 'success': 2, 'collisions': 10}, {'tx': 7, 'success': 1, 'collisions': 6}, {'tx': 16, 'success': 4, 'collisions': 12}, {'tx': 22, 'success': 10, 'collisions': 12}, {'tx': 10, 'success': 1, 'collisions': 9}, {'tx': 10, 'success': 1, 'collisions': 9}, {'tx': 17, 'success': 4, 'collisions': 13}, {'tx': 27, 'success': 13, 'collisions': 14}, {'tx': 12, 'success': 3, 'collisions': 9}, {'tx': 11, 'success': 3, 'collisions': 8}, {'tx': 11, 'success': 2, 'collisions': 9}, {'tx': 13, 'success': 4, 'collisions': 9}, {'tx': 13, 'success': 3, 'collisions': 10}, {'tx': 6, 'success': 1, 'collisions': 5}, {'tx': 23, 'success': 12, 'collisions': 11}]"
235,40,36,494,141,353,0.7145748987854251,0.2854251012145749,0.5076,"[{'tx': 16, 'success': 6, 'collisions': 10}, {'tx': 21, 'success': 7, 'collisions': 14}, {'tx': 18, 'success': 5, 'collisions': 13}, {'tx': 15, 'success': 5, 'collisions': 10}, {'tx': 14, 'success': 4, 'collisions': 10}, {'tx': 5, 'success': 1, 'collisions': 4}, {'tx': 7, 'success': 1, 'collisions': 6}, {'tx': 5, 'success': 0, 'collisions': 5}, {'tx': 11, 'success': 3, 'collisions': 8}, {'tx': 14, 'success': 4, 'collisions': 10}, {'tx': 5, 'success': 0, 'collisions': 5}, {'tx': 21, 'success': 10, 'collisions': 11}, {'tx': 8, 'success': 1, 'collisions': 7}, {'tx': 8, 'success': 1, 'collisions': 7}, {'tx': 24, 'success': 9, 'collisions': 15}, {'tx': 15, 'success': 6, 'collisions': 9}, {'tx': 15, 'success': 4, 'collisions': 11}, {'tx': 5, 'success': 0, 'collisions': 5}, {'tx': 18, 'success': 5, 'collisions': 13}, {'tx': 8, 'success': 1, 'collisions': 7}, {'tx': 5, 'success': 0, 'collisions': 5}, {'tx': 7, 'success': 1, 'collisions': 6}, {'tx': 14, 'success': 5, 'collisions': 9}, {'tx': 26, 'success': 13, 'collisions': 13}, {'tx': 5, 'success': 0, 'collisions': 5}, {'tx': 10, 'success': 2, 'collisions': 8}, {'tx': 13, 'success': 3, 'collisions': 10}, {'tx': 10, 'success': 2, 'collisions': 8}, {'tx': 13, 'success': 4, 'collisions': 9}, {'tx': 14, 'success': 3, 'collisions': 11}, {'tx': 16, 'success': 5, 'collisions': 11}, {'tx': 5, 'success': 0, 'collisions': 5}, {'tx': 18, 'success': 8, 'collisions': 10}, {'tx': 16, 'success': 5, 'collisions': 11}, {'tx': 13, 'success': 5, 'collisions': 8}, {'tx': 17, 'success': 4, 'collisions': 13}, {'tx': 15, 'success': 5, 'collisions': 10}, {'tx': 10, 'success': 2, 'collisions': 8}, {'tx': 8, 'success': 1, 'collisions': 7}, {'tx': 6, 'success': 0, 'collisions': 6}]"
236,40,37,469,143,326,0.6950959488272921,0.3049040511727079,0.5291,"[{'tx': 4, 'success': 0, 'collisions': 4}, {'tx': 27, 'success': 12, 'collisions': 15}, {'tx': 10, 'success': 2, 'collisions': 8}, {'tx': 11, 'success': 5, 'collisions': 6}, {'tx': 10, 'success': 2, 'collisions': 8}, {'tx': 5, 'success': 0, 'collisions': 5}, {'tx': 16, 'success': 8, 'collisions': 8}, {'tx': 5, 'success': 0, 'collisions': 5}, {'tx': 19, 'success': 8, 'collisions': 11}, {'tx': 4, 'success': 0, 'collisions': 4}, {'tx': 12, 'success': 3, 'collisions': 9}, {'tx': 5, 'success': 0, 'collisions': 5}, {'tx': 5, 'success': 0, 'collisions': 5}, {'tx': 15, 'success': 6, 'collisions': 9}, {'tx': 5, 'success': 0, 'collisions': 5}, {'tx': 5, 'success': 0, 'collisions': 5}, {'tx': 10, 'success': 2, 'collisions': 8}, {'tx': 13, 'success': 7, 'collisions': 6}, {'tx': 11, 'success': 3, 'collisions': 8}, {'tx': 7, 'success': 1, 'collisions': 6}, {'tx': 18, 'success': 6, 'collisions': 12}, {'tx': 21, 'success': 8, 'collisions': 13}, {'tx': 9, 'success': 1, 'collisions': 8}, {'tx': 18, 'success': 6, 'collisions': 12}, {'tx': 18, 'success': 7, 'collisions': 11}, {'tx': 6, 'success': 1, 'collisions': 5}, {'tx': 15, 'success': 4, 'collisions': 11}, {'tx': 19, 'success': 8, 'collisions': 11}, {'tx': 22, 'success': 8, 'collisions': 14}, {'tx': 6, 'success': 1, 'collisions': 5}, {'tx': 22, 'success': 9, 'collisions': 13}, {'tx': 5, 'success': 0, 'collisions': 5}, {'tx': 5, 'success': 0, 'collisions': 5}, {'tx': 13, 'success': 3, 'collisions': 10}, {'tx': 5, 'success': 0, 'collisions': 5}, {'tx': 13, 'success': 3, 'collisions': 10}, {'tx': 8, 'success': 1, 'collisions': 7}, {'tx': 21, 'success': 10, 'collisions': 11}, {'tx': 17, 'success': 6, 'collisions': 11}, {'tx': 9, 'success': 2, 'collisions': 7}]"
237,40,38,463,134,329,0.7105831533477321,0.2894168466522678,0.5092,"[{'tx': 9, 'success': 3, 'collisions': 6}, {'tx': 12, 'success': 4, 'collisions': 8}, {'tx': 15, 'success': 6, 'collisions': 9}, {'tx': 10, 'success': 2, 'collisions': 8}, {'tx': 9, 'success': 1, 'collisions': 8}, {'tx': 4, 'success': 0, 'collisions': 4}, {'tx': 10, 'success': 3, 'collisions': 7}, {'tx': 18, 'success': 8, 'collisions': 10}, {'tx': 6, 'success': 0, 'collisions': 6}, {'tx': 8, 'success': 1, 'collisions': 7}, {'tx': 14, 'success': 4, 'collisions': 10}, {'tx': 14, 'success': 4, 'collisions': 10}, {'tx': 16, 'success': 3, 'collisions': 13}, {'tx': 17, 'success': 10, 'collisions': 7}, {'tx': 8, 'success': 1, 'collisions': 7}, {'tx': 7, 'success': 1, 'collisions': 6}, {'tx': 9, 'success': 1, 'collisions': 8}, {'tx': 12, 'success': 3, 'collisions': 9}, {'tx': 13, 'success': 4, 'collisions': 9}, {'tx': 17, 'success': 5, 'collisions': 12}, {'tx': 10, 'success': 2, 'collisions': 8}, {'tx': 21, 'success': 10, 'collisions': 11}, {'tx': 5, 'success': 0, 'collisions': 5}, {'tx': 7, 'success': 1, 'collisions': 6}, {'tx': 18, 'success': 8, 'collisions': 10}, {'tx': 13, 'success': 5, 'collisions': 8}, {'tx': 18, 'success': 6, 'collisions': 12}, {'tx': 6, 'success': 0, 'collisions': 6}, {'tx': 14, 'success': 4, 'collisions': 10}, {'tx': 18, 'success': 6, 'collisions': 12}, {'tx': 15, 'success': 6, 'collisions': 9}, {'tx': 9, 'success': 1, 'collisions': 8}, {'tx': 18, 'success': 6, 'collisions': 12}, {'tx': 5, 'success': 0, 'collisions': 5}, {'tx': 7, 'success': 1, 'collisions': 6}, {'tx': 5, 'success': 0, 'collisions': 5}, {'tx': 23, 'success': 9, 'collisions': 14}, {'tx': 4, 'success': 0, 'collisions': 4}, {'tx': 14, 'success': 5, 'collisions': 9}, {'tx': 5, 'success': 0, 'collisions': 5}]"
238,40,39,458,132,326,0.7117903930131004,0.28820960698689957,0.5148,"[{'tx': 12, 'success': 3, 'collisions': 9}, {'tx': 5, 'success': 1, 'collisions': 4}, {'tx': 6, 'success': 2, 'collisions': 4}, {'tx': 22, 'success': 12, 'collisions': 10}, {'tx': 16, 'success': 5, 'collisions': 11}, {'tx': 5, 'success': 0, 'collisions': 5}, {'tx': 14, 'success': 5, 'collisions': 9}, {'tx': 10, 'success': 3, 'collisions': 7}, {'tx': 5, 'success': 0, 'collisions': 5}, {'tx': 25, 'success': 10, 'collisions': 15}, {'tx': 5, 'success': 0, 'collisions': 5}, {'tx': 14, 'success': 4, 'collisions': 10}, {'tx': 9, 'success': 3, 'collisions': 6}, {'tx': 22, 'success': 9, 'collisions': 13}, {'tx': 15, 'success': 5, 'collisions': 10}, {'tx': 13, 'success': 2, 'collisions': 11}, {'tx': 5, 'success': 0, 'collisions': 5}, {'tx': 9, 'success': 2, 'collisions': 7}, {'tx': 15, 'success': 5, 'collisions': 10}, {'tx': 9, 'success': 2, 'collisions': 7}, {'tx': 15, 'success': 6, 'collisions': 9}, {'tx': 5, 'success': 0, 'collisions': 5}, {'tx': 7, 'success': 1, 'collisions': 6}, {'tx': 17, 'success': 4, 'collisions': 13}, {'tx': 24, 'success': 9, 'collisions': 15}, {'tx': 10, 'success': 4, 'collisions': 6}, {'tx': 9, 'success': 1, 'collisions': 8}, {'tx': 8, 'success': 1, 'collisions': 7}, {'tx': 9, 'success': 1, 'collisions': 8}, {'tx': 5, 'success': 0, 'collisions': 5}, {'tx': 12, 'success': 5, 'collisions': 7}, {'tx': 10, 'success': 3, 'collisions': 7}, {'tx': 24, 'success': 9, 'collisions': 15}, {'tx': 6, 'success': 1, 'collisions': 5}, {'tx': 13, 'success': 3, 'collisions': 10}, {'tx': 8, 'success': 1, 'collisions': 7}, {'tx': 12, 'success': 4, 'collisions': 8}, {'tx': 10, 'success': 2, 'collisions': 8}, {'tx': 5, 'success': 0, 'collisions': 5}, {'tx': 13, 'success': 4, 'collisions': 9}]"
239,40,40,442,129,313,0.7081447963800905,0.2918552036199095,0.516,"[{'tx': 18, 'success': 6, 'collisions': 12}, {'tx': 13, 'success': 3, 'collisions': 10}, {'tx': 19, 'success': 8, 'collisions': 11}, {'tx': 16, 'success': 5, 'collisions': 11}, {'tx': 5, 'success': 0, 'collisions': 5}, {'tx': 14, 'success': 4, 'collisions': 10}, {'tx': 14, 'success': 5, 'collisions': 9}, {'tx': 7, 'success': 1, 'collisions': 6}, {'tx': 6, 'success': 0, 'collisions': 6}, {'tx': 10, 'success': 3, 'collisions': 7}, {'tx': 15, 'success': 4, 'collisions': 11}, {'tx': 9, 'success': 3, 'collisions': 6}, {'tx': 10, 'success': 2, 'collisions': 8}, {'tx': 10, 'success': 2, 'collisions': 8}, {'tx': 5, 'success': 0, 'collisions': 5}, {'tx': 6, 'success': 0, 'collisions': 6}, {'tx': 6, 'success': 0, 'collisions': 6}, {'tx': 4, 'success': 0, 'collisions': 4}, {'tx': 7, 'success': 1, 'collisions': 6}, {'tx': 11, 'success': 3, 'collisions': 8}, {'tx': 9, 'success': 1, 'collisions': 8}, {'tx': 17, 'success': 8, 'collisions': 9}, {'tx': 14, 'success': 5, 'collisions': 9}, {'tx': 12, 'success': 3, 'collisions': 9}, {'tx': 5, 'success': 1, 'collisions': 4}, {'tx': 15, 'success': 5, 'collisions': 10}, {'tx': 8, 'success': 1, 'collisions': 7}, {'tx': 11, 'success': 6, 'collisions': 5}, {'tx': 16, 'success': 8, 'collisions': 8}, {'tx': 17, 'success': 7, 'collisions': 10}, {'tx': 19, 'success': 9, 'collisions': 10}, {'tx': 14, 'success': 5, 'collisions': 9}, {'tx': 10, 'success': 2, 'collisions': 8}, {'tx': 5, 'success': 1, 'collisions': 4}, {'tx': 5, 'success': 0, 'collisions': 5}, {'tx': 8, 'success': 1, 'collisions': 7}, {'tx': 5, 'success': 0, 'collisions': 5}, {'tx': 19, 'success': 9, 'collisions': 10}, {'tx': 13, 'success': 3, 'collisions': 10}, {'tx': 15, 'success': 4, 'collisions': 11}]"
240,40,41,429,125,304,0.7086247086247086,0.2913752913752914,0.5125,"[{'tx': 11, 'success': 1, 'collisions': 10}, {'tx': 13, 'success': 6, 'collisions': 7}, {'tx': 20, 'success': 8, 'collisions': 12}, {'tx': 14, 'success': 6, 'collisions': 8}, {'tx': 8, 'success': 1, 'collisions': 7}, {'tx': 21, 'success': 8, 'collisions': 13}, {'tx': 5, 'success': 0, 'collisions': 5}, {'tx': 10, 'success': 3, 'collisions': 7}, {'tx': 21, 'success': 9, 'collisions': 12}, {'tx': 19, 'success': 9, 'collisions': 10}, {'tx': 15, 'success': 4, 'collisions': 11}, {'tx': 14, 'success': 5, 'collisions': 9}, {'tx': 12, 'success': 3, 'collisions': 9}, {'tx': 12, 'success': 3, 'collisions': 9}, {'tx': 21, 'success': 10, 'collisions': 11}, {'tx': 9, 'success': 1, 'collisions': 8}, {'tx': 4, 'success': 0, 'collisions': 4}, {'tx': 4, 'success': 0, 'collisions': 4}, {'tx': 9, 'success': 3, 'collisions': 6}, {'tx': 17, 'success': 6, 'collisions': 11}, {'tx': 6, 'success': 1, 'collisions': 5}, {'tx': 15, 'success': 6, 'collisions': 9}, {'tx': 5, 'success': 0, 'collisions': 5}, {'tx': 15, 'success': 6, 'collisions': 9}, {'tx': 5, 'success': 0, 'collisions': 5}, {'tx': 20, 'success': 8, 'collisions': 12}, {'tx': 6, 'success': 0, 'collisions': 6}, {'tx': 7, 'success': 1, 'collisions': 6}, {'tx': 6, 'success': 1, 'collisions': 5}, {'tx': 5, 'success': 0, 'collisions': 5}, {'tx': 5, 'success': 0, 'collisions': 5}, {'tx': 8, 'success': 1, 'collisions': 7}, {'tx': 8, 'success': 1, 'collisions': 7}, {'tx': 5, 'success': 0, 'collisions': 5}, {'tx': 15, 'success': 7, 'collisions': 8}, {'tx': 8, 'success': 2, 'collisions': 6}, {'tx': 7, 'success': 1, 'collisions': 6}, {'tx': 5, 'success': 0, 'collisions': 5}, {'tx': 8, 'success': 2, 'collisions': 6}, {'tx': 11, 'success': 2, 'collisions': 9}]"
241,40,42,420,116,304,0.7238095238095238,0.2761904761904762,0.4872,"[{'tx': 16, 'success': 5, 'collisions': 11}, {'tx': 8, 'success': 2, 'collisions': 6}, {'tx': 5, 'success': 0, 'collisions': 5}, {'tx': 5, 'success': 0, 'collisions': 5}, {'tx': 11, 'success': 3, 'collisions': 8}, {'tx': 12, 'success': 4, 'collisions': 8}, {'tx': 4, 'success': 0, 'collisions': 4}, {'tx': 17, 'success': 6, 'collisions': 11}, {'tx': 9, 'success': 1, 'collisions': 8}, {'tx': 13, 'success': 5, 'collisions': 8}, {'tx': 4, 'success': 0, 'collisions': 4}, {'tx': 20, 'success': 9, 'collisions': 11}, {'tx': 14, 'success': 5, 'collisions': 9}, {'tx': 7, 'success': 1, 'collisions': 6}, {'tx': 5, 'success': 0, 'collisions': 5}, {'tx': 11, 'success': 2, 'collisions': 9}, {'tx': 19, 'success': 8, 'collisions': 11}, {'tx': 16, 'success': 7, 'collisions': 9}, {'tx': 10, 'success': 2, 'collisions': 8}, {'tx': 8, 'success': 2, 'collisions': 6}, {'tx': 5, 'success': 0, 'collisions': 5}, {'tx': 8, 'success': 1, 'collisions': 7}, {'tx': 8, 'success': 1, 'collisions': 7}, {'tx': 8, 'success': 1, 'collisions': 7}, {'tx': 9, 'success': 2, 'collisions': 7}, {'tx': 11, 'success': 4, 'collisions': 7}, {'tx': 8, 'success': 2, 'collisions': 6}, {'tx': 16, 'success': 6, 'collisions': 10}, {'tx': 18, 'success': 7, 'collisions': 11}, {'tx': 14, 'success': 4, 'collisions': 10}, {'tx': 5, 'success': 0, 'collisions': 5}, {'tx': 7, 'success': 1, 'collisions': 6}, {'tx': 5, 'success': 0, 'collisions': 5}, {'tx': 8, 'success': 1, 'collisions': 7}, {'tx': 6, 'success': 2, 'collisions': 4}, {'tx': 16, 'success': 7, 'collisions': 9}, {'tx': 16, 'success': 4, 'collisions': 12}, {'tx': 5, 'success': 0, 'collisions': 5}, {'tx': 22, 'success': 9, 'collisions': 13}, {'tx': 11, 'success': 2, 'collisions': 9}]"
242,40,43,414,119,295,0.7125603864734299,0.28743961352657005,0.5117,"[{'tx': 13, 'success': 5, 'collisions': 8}, {'tx': 5, 'success': 0, 'collisions': 5}, {'tx': 11, 'success': 3, 'collisions': 8}, {'tx': 8, 'success': 1, 'collisions': 7}, {'tx': 5, 'success': 0, 'collisions': 5}, {'tx': 8, 'success': 1, 'collisions': 7}, {'tx': 5, 'success': 0, 'collisions': 5}, {'tx': 10, 'success': 2, 'collisions': 8}, {'tx': 12, 'success': 3, 'collisions': 9}, {'tx': 5, 'success': 0, 'collisions': 5}, {'tx': 5, 'success': 0, 'collisions': 5}, {'tx': 9, 'success': 3, 'collisions': 6}, {'tx': 18, 'success': 8, 'collisions': 10}, {'tx': 5, 'success': 1, 'collisions': 4}, {'tx': 25, 'success': 11, 'collisions': 14}, {'tx': 5, 'success': 0, 'collisions': 5}, {'tx': 6, 'success': 1, 'collisions': 5}, {'tx': 14, 'success': 5, 'collisions': 9}, {'tx': 14, 'success': 4, 'collisions': 10}, {'tx': 18, 'success': 6, 'collisions': 12}, {'tx': 6, 'success': 1, 'collisions': 5}, {'tx': 11, 'success': 4, 'collisions': 7}, {'tx': 11, 'success': 2, 'collisions': 9}, {'tx': 13, 'success': 2, 'collisions': 11}, {'tx': 5, 'success': 0, 'collisions': 5}, {'tx': 13, 'success': 7, 'collisions': 6}, {'tx': 9, 'success': 2, 'collisions': 7}, {'tx': 10, 'success': 4, 'collisions': 6}, {'tx': 5, 'success': 0, 'collisions': 5}, {'tx': 6, 'success': 1, 'collisions': 5}, {'tx': 13, 'success': 5, 'collisions': 8}, {'tx': 11, 'success': 2, 'collisions': 9}, {'tx': 21, 'success': 10, 'collisions': 11}, {'tx': 5, 'success': 0, 'collisions': 5}, {'tx': 18, 'success': 7, 'collisions': 11}, {'tx': 19, 'success': 8, 'collisions': 11}, {'tx': 4, 'success': 0, 'collisions': 4}, {'tx': 6, 'success': 1, 'collisions': 5}, {'tx': 18, 'success': 8, 'collisions': 10}, {'tx': 9, 'success': 1, 'collisions': 8}]"
243,40,44,398,113,285,0.7160804020100503,0.28391959798994976,0.4972,"[{'tx': 5, 'success': 0, 'collisions': 5}, {'tx': 5, 'success': 0, 'collisions': 5}, {'tx': 10, 'success': 2, 'collisions': 8}, {'tx': 4, 'success': 0, 'collisions': 4}, {'tx': 10, 'success': 4, 'collisions': 6}, {'tx': 7, 'success': 2, 'collisions': 5}, {'tx': 4, 'success': 0, 'collisions': 4}, {'tx': 17, 'success': 6, 'collisions': 11}, {'tx': 5, 'success': 0, 'collisions': 5}, {'tx': 13, 'success': 5, 'collisions': 8}, {'tx': 11, 'success': 2, 'collisions': 9}, {'tx': 5, 'success': 0, 'collisions': 5}, {'tx': 5, 'success': 0, 'collisions': 5}, {'tx': 5, 'success': 0, 'collisions': 5}, {'tx': 6, 'success': 0, 'collisions': 6}, {'tx': 14, 'success': 6, 'collisions': 8}, {'tx': 5, 'success': 0, 'collisions': 5}, {'tx': 6, 'success': 0, 'collisions': 6}, {'tx': 5, 'success': 0, 'collisions': 5}, {'tx': 12, 'success': 3, 'collisions': 9}, {'tx': 7, 'success': 1, 'collisions': 6}, {'tx': 15, 'success': 8, 'collisions': 7}, {'tx': 5, 'success': 0, 'collisions': 5}, {'tx': 21, 'success': 5, 'collisions': 16}, {'tx': 5, 'success': 0, 'collisions': 5}, {'tx': 14, 'success': 5, 'collisions': 9}, {'tx': 31, 'success': 15, 'collisions': 16}, {'tx': 5, 'success': 0, 'collisions': 5}, {'tx': 22, 'success': 11, 'collisions': 11}, {'tx': 4, 'success': 0, 'collisions': 4}, {'tx': 5, 'success': 0, 'collisions': 5}, {'tx': 20, 'success': 8, 'collisions': 12}, {'tx': 5, 'success': 0, 'collisions': 5}, {'tx': 23, 'success': 13, 'collisions': 10}, {'tx': 6, 'success': 1, 'collisions': 5}, {'tx': 5, 'success': 0, 'collisions': 5}, {'tx': 13, 'success': 5, 'collisions': 8}, {'tx': 16, 'success': 5, 'collisions': 11}, {'tx': 14, 'success': 5, 'collisions': 9}, {'tx': 8, 'success': 1, 'collisions': 7}]"
244,40,45,396,110,286,0.7222222222222222,0.2777777777777778,0.495,"[{'tx': 5, 'success': 0, 'collisions': 5}, {'tx': 7, 'success': 1, 'collisions': 6}, {'tx': 9, 'success': 2, 'collisions': 7}, {'tx': 5, 'success': 0, 'collisions': 5}, {'tx': 10, 'success': 3, 'collisions': 7}, {'tx': 14, 'success': 6, 'collisions': 8}, {'tx': 20, 'success': 9, 'collisions': 11}, {'tx': 5, 'success': 0, 'collisions': 5}, {'tx': 13, 'success': 5, 'collisions': 8}, {'tx': 19, 'success': 7, 'collisions': 12}, {'tx': 13, 'success': 5, 'collisions': 8}, {'tx': 8, 'success': 1, 'collisions': 7}, {'tx': 4, 'success': 0, 'collisions': 4}, {'tx': 11, 'success': 2, 'collisions': 9}, {'tx': 9, 'success': 2, 'collisions': 7}, {'tx': 19, 'success': 11, 'collisions': 8}, {'tx': 7, 'success': 1, 'collisions': 6}, {'tx': 18, 'success': 8, 'collisions': 10}, {'tx': 11, 'success': 3, 'collisions': 8}, {'tx': 11, 'success': 4, 'collisions': 7}, {'tx': 4, 'success': 0, 'collisions': 4}, {'tx': 5, 'success': 0, 'collisions': 5}, {'tx': 5, 'success': 0, 'collisions': 5}, {'tx': 13, 'success': 3, 'collisions': 10}, {'tx': 8, 'success': 1, 'collisions': 7}, {'tx': 7, 'success': 1, 'collisions': 6}, {'tx': 16, 'success': 5, 'collisions': 11}, {'tx': 20, 'success': 7, 'collisions': 13}, {'tx': 19, 'success': 10, 'collisions': 9}, {'tx': 8, 'success': 1, 'collisions': 7}, {'tx': 5, 'success': 0, 'collisions': 5}, {'tx': 4, 'success': 0, 'collisions': 4}, {'tx': 8, 'success': 1, 'collisions': 7}, {'tx': 5, 'success': 0, 'collisions': 5}, {'tx': 5, 'success': 0, 'collisions': 5}, {'tx': 9, 'success': 2, 'collisions': 7}, {'tx': 5, 'success': 0, 'collisions': 5}, {'tx': 11, 'success': 3, 'collisions': 8}, {'tx': 13, 'success': 5, 'collisions': 8}, {'tx': 8, 'success': 1, 'collisions': 7}]"
245,40,46,385,107,278,0.7220779220779221,0.2779220779220779,0.4922,"[{'tx': 16, 'success': 6, 'collisions': 10}, {'tx': 21, 'success': 9, 'collisions': 12}, {'tx': 5, 'success': 0, 'collisions': 5}, {'tx': 22, 'success': 11, 'collisions': 11}, {'tx': 7, 'success': 1, 'collisions': 6}, {'tx': 13, 'success': 3, 'collisions': 10}, {'tx': 4, 'success': 0, 'collisions': 4}, {'tx': 15, 'success': 6, 'collisions': 9}, {'tx': 13, 'success': 5, 'collisions': 8}, {'tx': 4, 'success': 0, 'collisions': 4}, {'tx': 8, 'success': 1, 'collisions': 7}, {'tx': 16, 'success': 5, 'collisions': 11}, {'tx': 4, 'success': 0, 'collisions': 4}, {'tx': 4, 'success': 0, 'collisions': 4}, {'tx': 4, 'success': 0, 'collisions': 4}, {'tx': 16, 'success': 6, 'collisions': 10}, {'tx': 4, 'success': 0, 'collisions': 4}, {'tx': 5, 'success': 0, 'collisions': 5}, {'tx': 14, 'success': 6, 'collisions': 8}, {'tx': 17, 'success': 7, 'collisions': 10}, {'tx': 7, 'success': 1, 'collisions': 6}, {'tx': 5, 'success': 0, 'collisions': 5}, {'tx': 9, 'success': 2, 'collisions': 7}, {'tx': 12, 'success': 3, 'collisions': 9}, {'tx': 17, 'success': 5, 'collisions': 12}, {'tx': 7, 'success': 1, 'collisions': 6}, {'tx': 5, 'success': 0, 'collisions': 5}, {'tx': 14, 'success': 5, 'collisions': 9}, {'tx': 4, 'success': 0, 'collisions': 4}, {'tx': 4, 'success': 0, 'collisions': 4}, {'tx': 6, 'success': 1, 'collisions': 5}, {'tx': 4, 'success': 0, 'collisions': 4}, {'tx': 5, 'success': 0, 'collisions': 5}, {'tx': 12, 'success': 4, 'collisions': 8}, {'tx': 19, 'success': 7, 'collisions': 12}, {'tx': 4, 'success': 0, 'collisions': 4}, {'tx': 7, 'success': 1, 'collisions': 6}, {'tx': 12, 'success': 5, 'collisions': 7}, {'tx': 9, 'success': 3, 'collisions': 6}, {'tx': 11, 'success': 3, 'collisions': 8}]"
246,40,47,378,106,272,0.7195767195767195,0.2804232804232804,0.4982,"[{'tx': 4, 'success': 0, 'collisions': 4}, {'tx': 17, 'success': 8, 'collisions': 9}, {'tx': 8, 'success': 2, 'collisions': 6}, {'tx': 4, 'success': 0, 'collisions': 4}, {'tx': 5, 'success': 0, 'collisions': 5}, {'tx': 15, 'success': 4, 'collisions': 11}, {'tx': 15, 'success': 5, 'collisions': 10}, {'tx': 14, 'success': 6, 'collisions': 8}, {'tx': 8, 'success': 1, 'collisions': 7}, {'tx': 4, 'success': 0, 'collisions': 4}, {'tx': 7, 'success': 1, 'collisions': 6}, {'tx': 4, 'success': 0, 'collisions': 4}, {'tx': 12, 'success': 4, 'collisions': 8}, {'tx': 4, 'success': 0, 'collisions': 4}, {'tx': 8, 'success': 3, 'collisions': 5}, {'tx': 14, 'success': 5, 'collisions': 9}, {'tx': 17, 'success': 8, 'collisions': 9}, {'tx': 20, 'success': 9, 'collisions': 11}, {'tx': 5, 'success': 0, 'collisions': 5}, {'tx': 7, 'success': 1, 'collisions': 6}, {'tx': 10, 'success': 3, 'collisions': 7}, {'tx': 10, 'success': 2, 'collisions': 8}, {'tx': 14, 'success': 4, 'collisions': 10}, {'tx': 7, 'success': 1, 'collisions': 6}, {'tx': 8, 'success': 1, 'collisions': 7}, {'tx': 9, 'success': 1, 'collisions': 8}, {'tx': 6, 'success': 1, 'collisions': 5}, {'tx': 16, 'success': 8, 'collisions': 8}, {'tx': 8, 'success': 1, 'collisions': 7}, {'tx': 4, 'success': 0, 'collisions': 4}, {'tx': 5, 'success': 0, 'collisions': 5}, {'tx': 5, 'success': 0, 'collisions': 5}, {'tx': 5, 'success': 1, 'collisions': 4}, {'tx': 7, 'success': 2, 'collisions': 5}, {'tx': 16, 'success': 6, 'collisions': 10}, {'tx': 9, 'success': 2, 'collisions': 7}, {'tx': 11, 'success': 3, 'collisions': 8}, {'tx': 16, 'success': 7, 'collisions': 9}, {'tx': 16, 'success': 6, 'collisions': 10}, {'tx': 4, 'success': 0, 'collisions': 4}]"
247,40,48,368,107,261,0.7092391304347826,0.2907608695652174,0.5136,"[{'tx': 6, 'success': 1, 'collisions': 5}, {'tx': 4, 'success': 0, 'collisions': 4}, {'tx': 11, 'success': 4, 'collisions': 7}, {'tx': 9, 'success': 3, 'collisions': 6}, {'tx': 5, 'success': 0, 'collisions': 5}, {'tx': 5, 'success': 0, 'collisions': 5}, {'tx': 5, 'success': 0, 'collisions': 5}, {'tx': 10, 'success': 3, 'collisions': 7}, {'tx': 14, 'success': 6, 'collisions': 8}, {'tx': 12, 'success': 5, 'collisions': 7}, {'tx': 7, 'success': 1, 'collisions': 6}, {'tx': 5, 'success': 0, 'collisions': 5}, {'tx': 13, 'success': 5, 'collisions': 8}, {'tx': 11, 'success': 4, 'collisions': 7}, {'tx': 8, 'success': 1, 'collisions': 7}, {'tx': 18, 'success': 7, 'collisions': 11}, {'tx': 20, 'success': 11, 'collisions': 9}, {'tx': 6, 'success': 0, 'collisions': 6}, {'tx': 15, 'success': 7, 'collisions': 8}, {'tx': 10, 'success': 3, 'collisions': 7}, {'tx': 9, 'success': 2, 'collisions': 7}, {'tx': 4, 'success': 0, 'collisions': 4}, {'tx': 8, 'success': 1, 'collisions': 7}, {'tx': 14, 'success': 5, 'collisions': 9}, {'tx': 5, 'success': 0, 'collisions': 5}, {'tx': 16, 'success': 6, 'collisions': 10}, {'tx': 6, 'success': 1, 'collisions': 5}, {'tx': 4, 'success': 0, 'collisions': 4}, {'tx': 5, 'success': 0, 'collisions': 5}, {'tx': 10, 'success': 2, 'collisions': 8}, {'tx': 9, 'success': 2, 'collisions': 7}, {'tx': 5, 'success': 0, 'collisions': 5}, {'tx': 7, 'success': 2, 'collisions': 5}, {'tx': 18, 'success': 9, 'collisions': 9}, {'tx': 10, 'success': 3, 'collisions': 7}, {'tx': 12, 'success': 2, 'collisions': 10}, {'tx': 5, 'success': 0, 'collisions': 5}, {'tx': 6, 'success': 2, 'collisions': 4}, {'tx': 14, 'success': 8, 'collisions': 6}, {'tx': 7, 'success': 1, 'collisions': 6}]"
248,40,49,372,101,271,0.728494623655914,0.271505376344086,0.4949,"[{'tx': 18, 'success': 7, 'collisions': 11}, {'tx': 5, 'success': 0, 'collisions': 5}, {'tx': 5, 'success': 0, 'collisions': 5}, {'tx': 4, 'success': 0, 'collisions': 4}, {'tx': 5, 'success': 0, 'collisions': 5}, {'tx': 5, 'success': 0, 'collisions': 5}, {'tx': 5, 'success': 0, 'collisions': 5}, {'tx': 12, 'success': 4, 'collisions': 8}, {'tx': 13, 'success': 5, 'collisions': 8}, {'tx': 6, 'success': 1, 'collisions': 5}, {'tx': 15, 'success': 4, 'collisions': 11}, {'tx': 7, 'success': 1, 'collisions': 6}, {'tx': 8, 'success': 2, 'collisions': 6}, {'tx': 10, 'success': 2, 'collisions': 8}, {'tx': 15, 'success': 7, 'collisions': 8}, {'tx': 5, 'success': 0, 'collisions': 5}, {'tx': 10, 'success': 5, 'collisions': 5}, {'tx': 12, 'success': 3, 'collisions': 9}, {'tx': 4, 'success': 0, 'collisions': 4}, {'tx': 14, 'success': 6, 'collisions': 8}, {'tx': 10, 'success': 2, 'collisions': 8}, {'tx': 10, 'success': 5, 'collisions': 5}, {'tx': 21, 'success': 9, 'collisions': 12}, {'tx': 12, 'success': 3, 'collisions': 9}, {'tx': 8, 'success': 1, 'collisions': 7}, {'tx': 9, 'success': 1, 'collisions': 8}, {'tx': 4, 'success': 0, 'collisions': 4}, {'tx': 5, 'success': 1, 'collisions': 4}, {'tx': 5, 'success': 0, 'collisions': 5}, {'tx': 16, 'success': 7, 'collisions': 9}, {'tx': 7, 'success': 1, 'collisions': 6}, {'tx': 10, 'success': 2, 'collisions': 8}, {'tx': 9, 'success': 2, 'collisions': 7}, {'tx': 11, 'success': 3, 'collisions': 8}, {'tx': 4, 'success': 0, 'collisions': 4}, {'tx': 4, 'success': 0, 'collisions': 4}, {'tx': 18, 'success': 7, 'collisions': 11}, {'tx': 13, 'success': 5, 'collisions': 8}, {'tx': 5, 'success': 0, 'collisions': 5}, {'tx': 13, 'success': 5, 'collisions': 8}]"
249,40,50,364,101,263,0.7225274725274725,0.2774725274725275,0.505,"[{'tx': 12, 'success': 3, 'collisions': 9}, {'tx': 14, 'success': 4, 'collisions': 10}, {'tx': 7, 'success': 1, 'collisions': 6}, {'tx': 9, 'success': 2, 'collisions': 7}, {'tx': 15, 'success': 7, 'collisions': 8}, {'tx': 16, 'success': 7, 'collisions': 9}, {'tx': 4, 'success': 0, 'collisions': 4}, {'tx': 4, 'success': 0, 'collisions': 4}, {'tx': 9, 'success': 3, 'collisions': 6}, {'tx': 15, 'success': 6, 'collisions': 9}, {'tx': 6, 'success': 1, 'collisions': 5}, {'tx': 11, 'success': 4, 'collisions': 7}, {'tx': 4, 'success': 0, 'collisions': 4}, {'tx': 10, 'success': 2, 'collisions': 8}, {'tx': 17, 'success': 7, 'collisions': 10}, {'tx': 14, 'success': 6, 'collisions': 8}, {'tx': 4, 'success': 0, 'collisions': 4}, {'tx': 11, 'success': 4, 'collisions': 7}, {'tx': 8, 'success': 1, 'collisions': 7}, {'tx': 10, 'success': 3, 'collisions': 7}, {'tx': 13, 'success': 7, 'collisions': 6}, {'tx': 8, 'success': 1, 'collisions': 7}, {'tx': 11, 'success': 3, 'collisions': 8}, {'tx': 11, 'success': 4, 'collisions': 7}, {'tx': 5, 'success': 0, 'collisions': 5}, {'tx': 8, 'success': 2, 'collisions': 6}, {'tx': 8, 'success': 1, 'collisions': 7}, {'tx': 5, 'success': 0, 'collisions': 5}, {'tx': 4, 'success': 0, 'collisions': 4}, {'tx': 10, 'success': 3, 'collisions': 7}, {'tx': 8, 'success': 2, 'collisions': 6}, {'tx': 5, 'success': 0, 'collisions': 5}, {'tx': 9, 'success': 3, 'collisions': 6}, {'tx': 11, 'success': 5, 'collisions': 6}, {'tx': 5, 'success': 0, 'collisions': 5}, {'tx': 10, 'success': 3, 'collisions': 7}, {'tx': 13, 'success': 3, 'collisions': 10}, {'tx': 5, 'success': 0, 'collisions': 5}, {'tx': 9, 'success': 2, 'collisions': 7}, {'tx': 6, 'success': 1, 'collisions': 5}]"
250,40,51,347,99,248,0.7146974063400576,0.28530259365994237,0.5049,"[{'tx': 15, 'success': 4, 'collisions': 11}, {'tx': 10, 'success': 4, 'collisions': 6}, {'tx': 11, 'success': 3, 'collisions': 8}, {'tx': 8, 'success': 2, 'collisions': 6}, {'tx': 14, 'success': 8, 'collisions': 6}, {'tx': 9, 'success': 2, 'collisions': 7}, {'tx': 10, 'success': 3, 'collisions': 7}, {'tx': 7, 'success': 1, 'collisions': 6}, {'tx': 5, 'success': 0, 'collisions': 5}, {'tx': 7, 'success': 1, 'collisions': 6}, {'tx': 10, 'success': 4, 'collisions': 6}, {'tx': 6, 'success': 1, 'collisions': 5}, {'tx': 12, 'success': 4, 'collisions': 8}, {'tx': 5, 'success': 0, 'collisions': 5}, {'tx': 4, 'success': 0, 'collisions': 4}, {'tx': 16, 'success': 5, 'collisions': 11}, {'tx': 11, 'success': 4, 'collisions': 7}, {'tx': 14, 'success': 5, 'collisions': 9}, {'tx': 4, 'success': 0, 'collisions': 4}, {'tx': 8, 'success': 2, 'collisions': 6}, {'tx': 18, 'success': 11, 'collisions': 7}, {'tx': 4, 'success': 0, 'collisions': 4}, {'tx': 5, 'success': 1, 'collisions': 4}, {'tx': 4, 'success': 0, 'collisions': 4}, {'tx': 16, 'success': 7, 'collisions': 9}, {'tx': 12, 'success': 4, 'collisions': 8}, {'tx': 5, 'success': 0, 'collisions': 5}, {'tx': 11, 'success': 5, 'collisions': 6}, {'tx': 11, 'success': 4, 'collisions': 7}, {'tx': 5, 'success': 0, 'collisions': 5}, {'tx': 10, 'success': 2, 'collisions': 8}, {'tx': 4, 'success': 0, 'collisions': 4}, {'tx': 8, 'success': 3, 'collisions': 5}, {'tx': 12, 'success': 5, 'collisions': 7}, {'tx': 7, 'success': 1, 'collisions': 6}, {'tx': 7, 'success': 1, 'collisions': 6}, {'tx': 4, 'success': 0, 'collisions': 4}, {'tx': 4, 'success': 0, 'collisions': 4}, {'tx': 10, 'success': 2, 'collisions': 8}, {'tx': 4, 'success': 0, 'collisions': 4}]"
251,40,52,349,101,248,0.7106017191977078,0.28939828080229224,0.5252,"[{'tx': 16, 'success': 7, 'collisions': 9}, {'tx': 14, 'success': 4, 'collisions': 10}, {'tx': 13, 'success': 4, 'collisions': 9}, {'tx': 13, 'success': 5, 'collisions': 8}, {'tx': 14, 'success': 6, 'collisions': 8}, {'tx': 5, 'success': 1, 'collisions': 4}, {'tx': 10, 'success': 2, 'collisions': 8}, {'tx': 5, 'success': 0, 'collisions': 5}, {'tx': 18, 'success': 10, 'collisions': 8}, {'tx': 14, 'success': 6, 'collisions': 8}, {'tx': 5, 'success': 0, 'collisions': 5}, {'tx': 5, 'success': 0, 'collisions': 5}, {'tx': 17, 'success': 8, 'collisions': 9}, {'tx': 5, 'success': 0, 'collisions': 5}, {'tx': 6, 'success': 1, 'collisions': 5}, {'tx': 4, 'success': 0, 'collisions': 4}, {'tx': 11, 'success': 2, 'collisions': 9}, {'tx': 4, 'success': 0, 'collisions': 4}, {'tx': 4, 'success': 0, 'collisions': 4}, {'tx': 16, 'success': 9, 'collisions': 7}, {'tx': 7, 'success': 1, 'collisions': 6}, {'tx': 4, 'success': 0, 'collisions': 4}, {'tx': 6, 'success': 1, 'collisions': 5}, {'tx': 4, 'success': 0, 'collisions': 4}, {'tx': 11, 'success': 4, 'collisions': 7}, {'tx': 6, 'success': 1, 'collisions': 5}, {'tx': 4, 'success': 0, 'collisions': 4}, {'tx': 20, 'success': 11, 'collisions': 9}, {'tx': 11, 'success': 3, 'collisions': 8}, {'tx': 9, 'success': 3, 'collisions': 6}, {'tx': 5, 'success': 0, 'collisions': 5}, {'tx': 4, 'success': 0, 'collisions': 4}, {'tx': 5, 'success': 0, 'collisions': 5}, {'tx': 4, 'success': 0, 'collisions': 4}, {'tx': 16, 'success': 6, 'collisions': 10}, {'tx': 10, 'success': 4, 'collisions': 6}, {'tx': 4, 'success': 0, 'collisions': 4}, {'tx': 7, 'success': 1, 'collisions': 6}, {'tx': 8, 'success': 1, 'collisions': 7}, {'tx': 5, 'success': 0, 'collisions': 5}]"
252,40,53,348,97,251,0.7212643678160919,0.27873563218390807,0.5141,"[{'tx': 8, 'success': 1, 'collisions': 7}, {'tx': 4, 'success': 0, 'collisions': 4}, {'tx': 5, 'success': 0, 'collisions': 5}, {'tx': 5, 'success': 0, 'collisions': 5}, {'tx': 16, 'success': 10, 'collisions': 6}, {'tx': 7, 'success': 1, 'collisions': 6}, {'tx': 10, 'success': 4, 'collisions': 6}, {'tx': 11, 'success': 4, 'collisions': 7}, {'tx': 13, 'success': 4, 'collisions': 9}, {'tx': 7, 'success': 1, 'collisions': 6}, {'tx': 11, 'success': 3, 'collisions': 8}, {'tx': 8, 'success': 2, 'collisions': 6}, {'tx': 4, 'success': 0, 'collisions': 4}, {'tx': 20, 'success': 11, 'collisions': 9}, {'tx': 4, 'success': 0, 'collisions': 4}, {'tx': 7, 'success': 1, 'collisions': 6}, {'tx': 17, 'success': 8, 'collisions': 9}, {'tx': 10, 'success': 3, 'collisions': 7}, {'tx': 11, 'success': 3, 'collisions': 8}, {'tx': 11, 'success': 4, 'collisions': 7}, {'tx': 7, 'success': 2, 'collisions': 5}, {'tx': 8, 'success': 1, 'collisions': 7}, {'tx': 14, 'success': 4, 'collisions': 10}, {'tx': 4, 'success': 0, 'collisions': 4}, {'tx': 9, 'success': 2, 'collisions': 7}, {'tx': 8, 'success': 3, 'collisions': 5}, {'tx': 5, 'success': 1, 'collisions': 4}, {'tx': 6, 'success': 1, 'collisions': 5}, {'tx': 12, 'success': 3, 'collisions': 9}, {'tx': 5, 'success': 0, 'collisions': 5}, {'tx': 4, 'success': 0, 'collisions': 4}, {'tx': 5, 'success': 0, 'collisions': 5}, {'tx': 8, 'success': 3, 'collisions': 5}, {'tx': 11, 'success': 4, 'collisions': 7}, {'tx': 8, 'success': 1, 'collisions': 7}, {'tx': 8, 'success': 3, 'collisions': 5}, {'tx': 4, 'success': 0, 'collisions': 4}, {'tx': 10, 'success': 2, 'collisions': 8}, {'tx': 12, 'success': 3, 'collisions': 9}, {'tx': 11, 'success': 4, 'collisions': 7}]"
253,40,54,334,91,243,0.7275449101796407,0.27245508982035926,0.4914,"[{'tx': 4, 'success': 0, 'collisions': 4}, {'tx': 7, 'success': 1, 'collisions': 6}, {'tx': 9, 'success': 3, 'collisions': 6}, {'tx': 4, 'success': 0, 'collisions': 4}, {'tx': 6, 'success': 1, 'collisions': 5}, {'tx': 10, 'success': 2, 'collisions': 8}, {'tx': 13, 'success': 4, 'collisions': 9}, {'tx': 9, 'success': 3, 'collisions': 6}, {'tx': 15, 'success': 8, 'collisions': 7}, {'tx': 14, 'success': 8, 'collisions': 6}, {'tx': 7, 'success': 1, 'collisions': 6}, {'tx': 12, 'success': 4, 'collisions': 8}, {'tx': 5, 'success': 0, 'collisions': 5}, {'tx': 7, 'success': 1, 'collisions': 6}, {'tx': 6, 'success': 1, 'collisions': 5}, {'tx': 10, 'success': 2, 'collisions': 8}, {'tx': 4, 'success': 0, 'collisions': 4}, {'tx': 4, 'success': 0, 'collisions': 4}, {'tx': 15, 'success': 8, 'collisions': 7}, {'tx': 4, 'success': 0, 'collisions': 4}, {'tx': 10, 'success': 1, 'collisions': 9}, {'tx': 8, 'success': 1, 'collisions': 7}, {'tx': 7, 'success': 1, 'collisions': 6}, {'tx': 11, 'success': 3, 'collisions': 8}, {'tx': 12, 'success': 5, 'collisions': 7}, {'tx': 7, 'success': 1, 'collisions': 6}, {'tx': 7, 'success': 1, 'collisions': 6}, {'tx': 7, 'success': 1, 'collisions': 6}, {'tx': 7, 'success': 1, 'collisions': 6}, {'tx': 11, 'success': 2, 'collisions': 9}, {'tx': 16, 'success': 8, 'collisions': 8}, {'tx': 8, 'success': 2, 'collisions': 6}, {'tx': 13, 'success': 5, 'collisions': 8}, {'tx': 4, 'success': 0, 'collisions': 4}, {'tx': 4, 'success': 0, 'collisions': 4}, {'tx': 8, 'success': 2, 'collisions': 6}, {'tx': 4, 'success': 0, 'collisions': 4}, {'tx': 7, 'success': 3, 'collisions': 4}, {'tx': 5, 'success': 1, 'collisions': 4}, {'tx': 13, 'success': 6, 'collisions': 7}]"
254,40,55,341,93,248,0.7272727272727273,0.2727272727272727,0.5115,"[{'tx': 12, 'success': 5, 'collisions': 7}, {'tx': 10, 'success': 4, 'collisions': 6}, {'tx': 6, 'success': 1, 'collisions': 5}, {'tx': 4, 'success': 0, 'collisions': 4}, {'tx': 15, 'success': 5, 'collisions': 10}, {'tx': 12, 'success': 4, 'collisions': 8}, {'tx': 4, 'success': 0, 'collisions': 4}, {'tx': 6, 'success': 3, 'collisions': 3}, {'tx': 9, 'success': 2, 'collisions': 7}, {'tx': 14, 'success': 6, 'collisions': 8}, {'tx': 10, 'success': 3, 'collisions': 7}, {'tx': 4, 'success': 0, 'collisions': 4}, {'tx': 7, 'success': 1, 'collisions': 6}, {'tx': 4, 'success': 0, 'collisions': 4}, {'tx': 12, 'success': 4, 'collisions': 8}, {'tx': 5, 'success': 0, 'collisions': 5}, {'tx': 7, 'success': 2, 'collisions': 5}, {'tx': 5, 'success': 0, 'collisions': 5}, {'tx': 7, 'success': 1, 'collisions': 6}, {'tx': 9, 'success': 2, 'collisions': 7}, {'tx': 15, 'success': 8, 'collisions': 7}, {'tx': 12, 'success': 4, 'collisions': 8}, {'tx': 7, 'success': 1, 'collisions': 6}, {'tx': 15, 'success': 5, 'collisions': 10}, {'tx': 7, 'success': 1, 'collisions': 6}, {'tx': 9, 'success': 2, 'collisions': 7}, {'tx': 10, 'success': 3, 'collisions': 7}, {'tx': 8, 'success': 2, 'collisions': 6}, {'tx': 11, 'success': 4, 'collisions': 7}, {'tx': 4, 'success': 0, 'collisions': 4}, {'tx': 16, 'success': 8, 'collisions': 8}, {'tx': 4, 'success': 0, 'collisions': 4}, {'tx': 9, 'success': 2, 'collisions': 7}, {'tx': 8, 'success': 1, 'collisions': 7}, {'tx': 4, 'success': 0, 'collisions': 4}, {'tx': 10, 'success': 1, 'collisions': 9}, {'tx': 6, 'success': 1, 'collisions': 5}, {'tx': 9, 'success': 3, 'collisions': 6}, {'tx': 10, 'success': 4, 'collisions': 6}, {'tx': 5, 'success': 0, 'collisions': 5}]"
255,40,56,332,80,252,0.7590361445783133,0.24096385542168675,0.448,"[{'tx': 9, 'success': 4, 'collisions': 5}, {'tx': 7, 'success': 1, 'collisions': 6}, {'tx': 4, 'success': 0, 'collisions': 4}, {'tx': 11, 'success': 2, 'collisions': 9}, {'tx': 6, 'success': 1, 'collisions': 5}, {'tx': 4, 'success': 0, 'collisions': 4}, {'tx': 12, 'success': 3, 'collisions': 9}, {'tx': 9, 'success': 3, 'collisions': 6}, {'tx': 21, 'success': 11, 'collisions': 10}, {'tx': 9, 'success': 1, 'collisions': 8}, {'tx': 4, 'success': 0, 'collisions': 4}, {'tx': 15, 'success': 4, 'collisions': 11}, {'tx': 6, 'success': 0, 'collisions': 6}, {'tx': 9, 'success': 2, 'collisions': 7}, {'tx': 5, 'success': 0, 'collisions': 5}, {'tx': 13, 'success': 3, 'collisions': 10}, {'tx': 5, 'success': 1, 'collisions': 4}, {'tx': 8, 'success': 2, 'collisions': 6}, {'tx': 9, 'success': 2, 'collisions': 7}, {'tx': 5, 'success': 0, 'collisions': 5}, {'tx': 4, 'success': 0, 'collisions': 4}, {'tx': 10, 'success': 3, 'collisions': 7}, {'tx': 8, 'success': 2, 'collisions': 6}, {'tx': 5, 'success': 0, 'collisions': 5}, {'tx': 7, 'success': 1, 'collisions': 6}, {'tx': 16, 'success': 9, 'collisions': 7}, {'tx': 8, 'success': 1, 'collisions': 7}, {'tx': 7, 'success': 1, 'collisions': 6}, {'tx': 5, 'success': 0, 'collisions': 5}, {'tx': 15, 'success': 5, 'collisions': 10}, {'tx': 5, 'success': 0, 'collisions': 5}, {'tx': 19, 'success': 12, 'collisions': 7}, {'tx': 5, 'success': 0, 'collisions': 5}, {'tx': 7, 'success': 1, 'collisions': 6}, {'tx': 6, 'success': 0, 'collisions': 6}, {'tx': 9, 'success': 2, 'collisions': 7}, {'tx': 4, 'success': 0, 'collisions': 4}, {'tx': 13, 'success': 3, 'collisions': 10}, {'tx': 4, 'success': 0, 'collisions': 4}, {'tx': 4, 'success': 0, 'collisions': 4}]"
256,40,57,334,86,248,0.7425149700598802,0.25748502994011974,0.4902,"[{'tx': 4, 'success': 0, 'collisions': 4}, {'tx': 12, 'success': 5, 'collisions': 7}, {'tx': 19, 'success': 11, 'collisions': 8}, {'tx': 8, 'success': 1, 'collisions': 7}, {'tx': 14, 'success': 4, 'collisions': 10}, {'tx': 5, 'success': 0, 'collisions': 5}, {'tx': 13, 'success': 5, 'collisions': 8}, {'tx': 10, 'success': 4, 'collisions': 6}, {'tx': 12, 'success': 5, 'collisions': 7}, {'tx': 5, 'success': 0, 'collisions': 5}, {'tx': 6, 'success': 1, 'collisions': 5}, {'tx': 5, 'success': 0, 'collisions': 5}, {'tx': 7, 'success': 1, 'collisions': 6}, {'tx': 8, 'success': 2, 'collisions': 6}, {'tx': 4, 'success': 0, 'collisions': 4}, {'tx': 4, 'success': 0, 'collisions': 4}, {'tx': 7, 'success': 1, 'collisions': 6}, {'tx': 4, 'success': 0, 'collisions': 4}, {'tx': 8, 'success': 1, 'collisions': 7}, {'tx': 8, 'success': 3, 'collisions': 5}, {'tx': 9, 'success': 2, 'collisions': 7}, {'tx': 12, 'success': 3, 'collisions': 9}, {'tx': 5, 'success': 0, 'collisions': 5}, {'tx': 4, 'success': 0, 'collisions': 4}, {'tx': 9, 'success': 2, 'collisions': 7}, {'tx': 10, 'success': 2, 'collisions': 8}, {'tx': 4, 'success': 0, 'collisions': 4}, {'tx': 5, 'success': 0, 'collisions': 5}, {'tx': 7, 'success': 1, 'collisions': 6}, {'tx': 4, 'success': 0, 'collisions': 4}, {'tx': 6, 'success': 1, 'collisions': 5}, {'tx': 12, 'success': 4, 'collisions': 8}, {'tx': 13, 'success': 5, 'collisions': 8}, {'tx': 16, 'success': 8, 'collisions': 8}, {'tx': 13, 'success': 4, 'collisions': 9}, {'tx': 12, 'success': 4, 'collisions': 8}, {'tx': 9, 'success': 2, 'collisions': 7}, {'tx': 4, 'success': 0, 'collisions': 4}, {'tx': 10, 'success': 3, 'collisions': 7}, {'tx': 7, 'success': 1, 'collisions': 6}]"
257,40,58,321,79,242,0.7538940809968847,0.24610591900311526,0.4582,"[{'tx': 9, 'success': 3, 'collisions': 6}, {'tx': 6, 'success': 2, 'collisions': 4}, {'tx': 13, 'success': 5, 'collisions': 8}, {'tx': 10, 'success': 4, 'collisions': 6}, {'tx': 5, 'success': 0, 'collisions': 5}, {'tx': 4, 'success': 0, 'collisions': 4}, {'tx': 4, 'success': 0, 'collisions': 4}, {'tx': 5, 'success': 0, 'collisions': 5}, {'tx': 12, 'success': 6, 'collisions': 6}, {'tx': 6, 'success': 1, 'collisions': 5}, {'tx': 5, 'success': 0, 'collisions': 5}, {'tx': 4, 'success': 0, 'collisions': 4}, {'tx': 10, 'success': 3, 'collisions': 7}, {'tx': 4, 'success': 0, 'collisions': 4}, {'tx': 12, 'success': 3, 'collisions': 9}, {'tx': 7, 'success': 1, 'collisions': 6}, {'tx': 7, 'success': 1, 'collisions': 6}, {'tx': 8, 'success': 2, 'collisions': 6}, {'tx': 10, 'success': 3, 'collisions': 7}, {'tx': 11, 'success': 3, 'collisions': 8}, {'tx': 5, 'success': 0, 'collisions': 5}, {'tx': 16, 'success': 6, 'collisions': 10}, {'tx': 4, 'success': 0, 'collisions': 4}, {'tx': 4, 'success': 0, 'collisions': 4}, {'tx': 14, 'success': 4, 'collisions': 10}, {'tx': 5, 'success': 0, 'collisions': 5}, {'tx': 4, 'success': 0, 'collisions': 4}, {'tx': 8, 'success': 3, 'collisions': 5}, {'tx': 11, 'success': 5, 'collisions': 6}, {'tx': 9, 'success': 2, 'collisions': 7}, {'tx': 11, 'success': 3, 'collisions': 8}, {'tx': 8, 'success': 1, 'collisions': 7}, {'tx': 10, 'success': 3, 'collisions': 7}, {'tx': 4, 'success': 0, 'collisions': 4}, {'tx': 12, 'success': 4, 'collisions': 8}, {'tx': 15, 'success': 6, 'collisions': 9}, {'tx': 7, 'success': 1, 'collisions': 6}, {'tx': 5, 'success': 0, 'collisions': 5}, {'tx': 5, 'success': 0, 'collisions': 5}, {'tx': 12, 'success': 4, 'collisions': 8}]"
258,40,59,314,88,226,0.7197452229299363,0.2802547770700637,0.5192,"[{'tx': 8, 'success': 3, 'collisions': 5}, {'tx': 4, 'success': 0, 'collisions': 4}, {'tx': 5, 'success': 0, 'collisions': 5}, {'tx': 12, 'success': 4, 'collisions': 8}, {'tx': 12, 'success': 6, 'collisions': 6}, {'tx': 6, 'success': 1, 'collisions': 5}, {'tx': 10, 'success': 4, 'collisions': 6}, {'tx': 17, 'success': 10, 'collisions': 7}, {'tx': 10, 'success': 4, 'collisions': 6}, {'tx': 9, 'success': 3, 'collisions': 6}, {'tx': 5, 'success': 0, 'collisions': 5}, {'tx': 13, 'success': 5, 'collisions': 8}, {'tx': 4, 'success': 0, 'collisions': 4}, {'tx': 7, 'success': 1, 'collisions': 6}, {'tx': 14, 'success': 8, 'collisions': 6}, {'tx': 8, 'success': 2, 'collisions': 6}, {'tx': 16, 'success': 6, 'collisions': 10}, {'tx': 4, 'success': 0, 'collisions': 4}, {'tx': 11, 'success': 3, 'collisions': 8}, {'tx': 4, 'success': 0, 'collisions': 4}, {'tx': 7, 'success': 1, 'collisions': 6}, {'tx': 5, 'success': 0, 'collisions': 5}, {'tx': 4, 'success': 0, 'collisions': 4}, {'tx': 7, 'success': 1, 'collisions': 6}, {'tx': 8, 'success': 2, 'collisions': 6}, {'tx': 5, 'success': 0, 'collisions': 5}, {'tx': 16, 'success': 8, 'collisions': 8}, {'tx': 4, 'success': 0, 'collisions': 4}, {'tx': 9, 'success': 3, 'collisions': 6}, {'tx': 6, 'success': 1, 'collisions': 5}, {'tx': 4, 'success': 0, 'collisions': 4}, {'tx': 7, 'success': 1, 'collisions': 6}, {'tx': 11, 'success': 5, 'collisions': 6}, {'tx': 9, 'success': 2, 'collisions': 7}, {'tx': 7, 'success': 1, 'collisions': 6}, {'tx': 6, 'success': 1, 'collisions': 5}, {'tx': 5, 'success': 0, 'collisions': 5}, {'tx': 4, 'success': 0, 'collisions': 4}, {'tx': 4, 'success': 0, 'collisions': 4}, {'tx': 7, 'success': 2, 'collisions': 5}]"
259,40,60,301,82,219,0.7275747508305648,0.2724252491694352,0.492,"[{'tx': 5, 'success': 1, 'collisions': 4}, {'tx': 4, 'success': 0, 'collisions': 4}, {'tx': 4, 'success': 0, 'collisions': 4}, {'tx': 4, 'success': 0, 'collisions': 4}, {'tx': 4, 'success': 0, 'collisions': 4}, {'tx': 8, 'success': 2, 'collisions': 6}, {'tx': 12, 'success': 6, 'collisions': 6}, {'tx': 4, 'success': 0, 'collisions': 4}, {'tx': 4, 'success': 0, 'collisions': 4}, {'tx': 9, 'success': 3, 'collisions': 6}, {'tx': 4, 'success': 0, 'collisions': 4}, {'tx': 4, 'success': 0, 'collisions': 4}, {'tx': 14, 'success': 7, 'collisions': 7}, {'tx': 5, 'success': 1, 'collisions': 4}, {'tx': 4, 'success': 0, 'collisions': 4}, {'tx': 11, 'success': 4, 'collisions': 7}, {'tx': 13, 'success': 4, 'collisions': 9}, {'tx': 4, 'success': 0, 'collisions': 4}, {'tx': 4, 'success': 0, 'collisions': 4}, {'tx': 7, 'success': 1, 'collisions': 6}, {'tx': 12, 'success': 4, 'collisions': 8}, {'tx': 12, 'success': 5, 'collisions': 7}, {'tx': 8, 'success': 3, 'collisions': 5}, {'tx': 4, 'success': 0, 'collisions': 4}, {'tx': 7, 'success': 2, 'collisions': 5}, {'tx': 6, 'success': 2, 'collisions': 4}, {'tx': 13, 'success': 4, 'collisions': 9}, {'tx': 4, 'success': 0, 'collisions': 4}, {'tx': 17, 'success': 8, 'collisions': 9}, {'tx': 12, 'success': 5, 'collisions': 7}, {'tx': 14, 'success': 5, 'collisions': 9}, {'tx': 12, 'success': 5, 'collisions': 7}, {'tx': 5, 'success': 0, 'collisions': 5}, {'tx': 7, 'success': 1, 'collisions': 6}, {'tx': 7, 'success': 1, 'collisions': 6}, {'tx': 4, 'success': 0, 'collisions': 4}, {'tx': 8, 'success': 2, 'collisions': 6}, {'tx': 6, 'success': 1, 'collisions': 5}, {'tx': 4, 'success': 0, 'collisions': 4}, {'tx': 11, 'success': 5, 'collisions': 6}]"
260,40,61,303,74,229,0.7557755775577558,0.24422442244224424,0.4514,"[{'tx': 7, 'success': 1, 'collisions': 6}, {'tx': 4, 'success': 0, 'collisions': 4}, {'tx': 10, 'success': 4, 'collisions': 6}, {'tx': 7, 'success': 2, 'collisions': 5}, {'tx': 4, 'success': 0, 'collisions': 4}, {'tx': 6, 'success': 1, 'collisions': 5}, {'tx': 9, 'success': 2, 'collisions': 7}, {'tx': 6, 'success': 1, 'collisions': 5}, {'tx': 11, 'success': 4, 'collisions': 7}, {'tx': 10, 'success': 4, 'collisions': 6}, {'tx': 11, 'success': 5, 'collisions': 6}, {'tx': 13, 'success': 5, 'collisions': 8}, {'tx': 4, 'success': 0, 'collisions': 4}, {'tx': 4, 'success': 0, 'collisions': 4}, {'tx': 5, 'success': 1, 'collisions': 4}, {'tx': 4, 'success': 0, 'collisions': 4}, {'tx': 5, 'success': 0, 'collisions': 5}, {'tx': 5, 'success': 0, 'collisions': 5}, {'tx': 4, 'success': 0, 'collisions': 4}, {'tx': 12, 'success': 4, 'collisions': 8}, {'tx': 10, 'success': 3, 'collisions': 7}, {'tx': 11, 'success': 3, 'collisions': 8}, {'tx': 4, 'success': 0, 'collisions': 4}, {'tx': 14, 'success': 7, 'collisions': 7}, {'tx': 7, 'success': 1, 'collisions': 6}, {'tx': 10, 'success': 3, 'collisions': 7}, {'tx': 4, 'success': 0, 'collisions': 4}, {'tx': 8, 'success': 2, 'collisions': 6}, {'tx': 11, 'success': 3, 'collisions': 8}, {'tx': 9, 'success': 3, 'collisions': 6}, {'tx': 14, 'success': 4, 'collisions': 10}, {'tx': 7, 'success': 2, 'collisions': 5}, {'tx': 8, 'success': 2, 'collisions': 6}, {'tx': 4, 'success': 0, 'collisions': 4}, {'tx': 7, 'success': 1, 'collisions': 6}, {'tx': 12, 'success': 4, 'collisions': 8}, {'tx': 4, 'success': 0, 'collisions': 4}, {'tx': 7, 'success': 1, 'collisions': 6}, {'tx': 4, 'success': 0, 'collisions': 4}, {'tx': 7, 'success': 1, 'collisions': 6}]"
261,40,62,305,82,223,0.7311475409836066,0.26885245901639343,0.5084,"[{'tx': 9, 'success': 2, 'collisions': 7}, {'tx': 4, 'success': 0, 'collisions': 4}, {'tx': 4, 'success': 0, 'collisions': 4}, {'tx': 4, 'success': 0, 'collisions': 4}, {'tx': 11, 'success': 6, 'collisions': 5}, {'tx': 8, 'success': 3, 'collisions': 5}, {'tx': 10, 'success': 4, 'collisions': 6}, {'tx': 5, 'success': 0, 'collisions': 5}, {'tx': 11, 'success': 6, 'collisions': 5}, {'tx': 4, 'success': 0, 'collisions': 4}, {'tx': 4, 'success': 0, 'collisions': 4}, {'tx': 15, 'success': 7, 'collisions': 8}, {'tx': 9, 'success': 3, 'collisions': 6}, {'tx': 8, 'success': 3, 'collisions': 5}, {'tx': 12, 'success': 5, 'collisions': 7}, {'tx': 4, 'success': 0, 'collisions': 4}, {'tx': 9, 'success': 2, 'collisions': 7}, {'tx': 5, 'success': 1, 'collisions': 4}, {'tx': 9, 'success': 2, 'collisions': 7}, {'tx': 12, 'success': 3, 'collisions': 9}, {'tx': 11, 'success': 5, 'collisions': 6}, {'tx': 4, 'success': 0, 'collisions': 4}, {'tx': 5, 'success': 0, 'collisions': 5}, {'tx': 9, 'success': 4, 'collisions': 5}, {'tx': 6, 'success': 1, 'collisions': 5}, {'tx': 7, 'success': 1, 'collisions': 6}, {'tx': 6, 'success': 1, 'collisions': 5}, {'tx': 6, 'success': 1, 'collisions': 5}, {'tx': 8, 'success': 2, 'collisions': 6}, {'tx': 9, 'success': 2, 'collisions': 7}, {'tx': 4, 'success': 0, 'collisions': 4}, {'tx': 11, 'success': 4, 'collisions': 7}, {'tx': 14, 'success': 5, 'collisions': 9}, {'tx': 11, 'success': 3, 'collisions': 8}, {'tx': 11, 'success': 3, 'collisions': 8}, {'tx': 7, 'success': 2, 'collisions': 5}, {'tx': 4, 'success': 0, 'collisions': 4}, {'tx': 6, 'success': 1, 'collisions': 5}, {'tx': 4, 'success': 0, 'collisions': 4}, {'tx': 5, 'success': 0, 'collisions': 5}]"
262,40,63,298,75,223,0.7483221476510067,0.2516778523489933,0.4725,"[{'tx': 4, 'success': 0, 'collisions': 4}, {'tx': 10, 'success': 4, 'collisions': 6}, {'tx': 4, 'success': 0, 'collisions': 4}, {'tx': 11, 'success': 2, 'collisions': 9}, {'tx': 9, 'success': 3, 'collisions': 6}, {'tx': 5, 'success': 0, 'collisions': 5}, {'tx': 8, 'success': 1, 'collisions': 7}, {'tx': 11, 'success': 4, 'collisions': 7}, {'tx': 8, 'success': 2, 'collisions': 6}, {'tx': 7, 'success': 1, 'collisions': 6}, {'tx': 5, 'success': 1, 'collisions': 4}, {'tx': 10, 'success': 5, 'collisions': 5}, {'tx': 5, 'success': 0, 'collisions': 5}, {'tx': 7, 'success': 1, 'collisions': 6}, {'tx': 5, 'success': 0, 'collisions': 5}, {'tx': 4, 'success': 0, 'collisions': 4}, {'tx': 4, 'success': 0, 'collisions': 4}, {'tx': 5, 'success': 0, 'collisions': 5}, {'tx': 12, 'success': 6, 'collisions': 6}, {'tx': 5, 'success': 0, 'collisions': 5}, {'tx': 5, 'success': 0, 'collisions': 5}, {'tx': 7, 'success': 2, 'collisions': 5}, {'tx': 11, 'success': 4, 'collisions': 7}, {'tx': 6, 'success': 1, 'collisions': 5}, {'tx': 12, 'success': 4, 'collisions': 8}, {'tx': 8, 'success': 2, 'collisions': 6}, {'tx': 7, 'success': 3, 'collisions': 4}, {'tx': 6, 'success': 2, 'collisions': 4}, {'tx': 6, 'success': 1, 'collisions': 5}, {'tx': 9, 'success': 3, 'collisions': 6}, {'tx': 8, 'success': 2, 'collisions': 6}, {'tx': 5, 'success': 1, 'collisions': 4}, {'tx': 8, 'success': 2, 'collisions': 6}, {'tx': 8, 'success': 1, 'collisions': 7}, {'tx': 12, 'success': 4, 'collisions': 8}, {'tx': 12, 'success': 5, 'collisions': 7}, {'tx': 9, 'success': 3, 'collisions': 6}, {'tx': 5, 'success': 0, 'collisions': 5}, {'tx': 11, 'success': 5, 'collisions': 6}, {'tx': 4, 'success': 0, 'collisions': 4}]"
263,40,64,291,71,220,0.7560137457044673,0.24398625429553264,0.4544,"[{'tx': 10, 'success': 4, 'collisions': 6}, {'tx': 6, 'success': 0, 'collisions': 6}, {'tx': 6, 'success': 1, 'collisions': 5}, {'tx': 11, 'success': 3, 'collisions': 8}, {'tx': 5, 'success': 0, 'collisions': 5}, {'tx': 9, 'success': 2, 'collisions': 7}, {'tx': 5, 'success': 1, 'collisions': 4}, {'tx': 4, 'success': 0, 'collisions': 4}, {'tx': 6, 'success': 0, 'collisions': 6}, {'tx': 11, 'success': 4, 'collisions': 7}, {'tx': 8, 'success': 1, 'collisions': 7}, {'tx': 10, 'success': 5, 'collisions': 5}, {'tx': 4, 'success': 0, 'collisions': 4}, {'tx': 4, 'success': 0, 'collisions': 4}, {'tx': 7, 'success': 3, 'collisions': 4}, {'tx': 4, 'success': 0, 'collisions': 4}, {'tx': 13, 'success': 6, 'collisions': 7}, {'tx': 5, 'success': 0, 'collisions': 5}, {'tx': 7, 'success': 3, 'collisions': 4}, {'tx': 5, 'success': 0, 'collisions': 5}, {'tx': 4, 'success': 0, 'collisions': 4}, {'tx': 4, 'success': 0, 'collisions': 4}, {'tx': 5, 'success': 0, 'collisions': 5}, {'tx': 13, 'success': 4, 'collisions': 9}, {'tx': 12, 'success': 3, 'collisions': 9}, {'tx': 7, 'success': 2, 'collisions': 5}, {'tx': 4, 'success': 0, 'collisions': 4}, {'tx': 5, 'success': 1, 'collisions': 4}, {'tx': 8, 'success': 1, 'collisions': 7}, {'tx': 4, 'success': 0, 'collisions': 4}, {'tx': 9, 'success': 3, 'collisions': 6}, {'tx': 9, 'success': 2, 'collisions': 7}, {'tx': 4, 'success': 0, 'collisions': 4}, {'tx': 14, 'success': 6, 'collisions': 8}, {'tx': 4, 'success': 0, 'collisions': 4}, {'tx': 4, 'success': 0, 'collisions': 4}, {'tx': 9, 'success': 3, 'collisions': 6}, {'tx': 16, 'success': 8, 'collisions': 8}, {'tx': 10, 'success': 4, 'collisions': 6}, {'tx': 6, 'success': 1, 'collisions': 5}]"
264,40,65,288,75,213,0.7395833333333334,0.2604166666666667,0.4875,"[{'tx': 5, 'success': 1, 'collisions': 4}, {'tx': 14, 'success': 7, 'collisions': 7}, {'tx': 15, 'success': 7, 'collisions': 8}, {'tx': 6, 'success': 1, 'collisions': 5}, {'tx': 6, 'success': 0, 'collisions': 6}, {'tx': 5, 'success': 1, 'collisions': 4}, {'tx': 7, 'success': 1, 'collisions': 6}, {'tx': 7, 'success': 2, 'collisions': 5}, {'tx': 4, 'success': 0, 'collisions': 4}, {'tx': 3, 'success': 0, 'collisions': 3}, {'tx': 4, 'success': 0, 'collisions': 4}, {'tx': 6, 'success': 1, 'collisions': 5}, {'tx': 4, 'success': 0, 'collisions': 4}, {'tx': 7, 'success': 1, 'collisions': 6}, {'tx': 4, 'success': 0, 'collisions': 4}, {'tx': 4, 'success': 0, 'collisions': 4}, {'tx': 13, 'success': 6, 'collisions': 7}, {'tx': 8, 'success': 1, 'collisions': 7}, {'tx': 6, 'success': 1, 'collisions': 5}, {'tx': 9, 'success': 3, 'collisions': 6}, {'tx': 4, 'success': 1, 'collisions': 3}, {'tx': 13, 'success': 6, 'collisions': 7}, {'tx': 11, 'success': 4, 'collisions': 7}, {'tx': 5, 'success': 0, 'collisions': 5}, {'tx': 8, 'success': 3, 'collisions': 5}, {'tx': 9, 'success': 4, 'collisions': 5}, {'tx': 12, 'success': 5, 'collisions': 7}, {'tx': 7, 'success': 1, 'collisions': 6}, {'tx': 6, 'success': 1, 'collisions': 5}, {'tx': 4, 'success': 0, 'collisions': 4}, {'tx': 4, 'success': 0, 'collisions': 4}, {'tx': 5, 'success': 0, 'collisions': 5}, {'tx': 5, 'success': 0, 'collisions': 5}, {'tx': 7, 'success': 2, 'collisions': 5}, {'tx': 14, 'success': 7, 'collisions': 7}, {'tx': 6, 'success': 1, 'collisions': 5}, {'tx': 8, 'success': 2, 'collisions': 6}, {'tx': 4, 'success': 0, 'collisions': 4}, {'tx': 6, 'success': 1, 'collisions': 5}, {'tx': 13, 'success': 4, 'collisions': 9}]"
265,40,66,286,72,214,0.7482517482517482,0.2517482517482518,0.4752,"[{'tx': 7, 'success': 1, 'collisions': 6}, {'tx': 4, 'success': 0, 'collisions': 4}, {'tx': 6, 'success': 2, 'collisions': 4}, {'tx': 4, 'success': 0, 'collisions': 4}, {'tx': 4, 'success': 0, 'collisions': 4}, {'tx': 13, 'success': 6, 'collisions': 7}, {'tx': 4, 'success': 0, 'collisions': 4}, {'tx': 9, 'success': 1, 'collisions': 8}, {'tx': 4, 'success': 0, 'collisions': 4}, {'tx': 11, 'success': 5, 'collisions': 6}, {'tx': 5, 'success': 0, 'collisions': 5}, {'tx': 4, 'success': 0, 'collisions': 4}, {'tx': 15, 'success': 7, 'collisions': 8}, {'tx': 9, 'success': 2, 'collisions': 7}, {'tx': 4, 'success': 0, 'collisions': 4}, {'tx': 9, 'success': 2, 'collisions': 7}, {'tx': 10, 'success': 2, 'collisions': 8}, {'tx': 5, 'success': 0, 'collisions': 5}, {'tx': 3, 'success': 0, 'collisions': 3}, {'tx': 4, 'success': 0, 'collisions': 4}, {'tx': 13, 'success': 5, 'collisions': 8}, {'tx': 6, 'success': 1, 'collisions': 5}, {'tx': 4, 'success': 0, 'collisions': 4}, {'tx': 6, 'success': 1, 'collisions': 5}, {'tx': 4, 'success': 0, 'collisions': 4}, {'tx': 4, 'success': 0, 'collisions': 4}, {'tx': 4, 'success': 0, 'collisions': 4}, {'tx': 8, 'success': 3, 'collisions': 5}, {'tx': 5, 'success': 0, 'collisions': 5}, {'tx': 15, 'success': 7, 'collisions': 8}, {'tx': 7, 'success': 2, 'collisions': 5}, {'tx': 4, 'success': 0, 'collisions': 4}, {'tx': 4, 'success': 0, 'collisions': 4}, {'tx': 4, 'success': 0, 'collisions': 4}, {'tx': 12, 'success': 5, 'collisions': 7}, {'tx': 6, 'success': 1, 'collisions': 5}, {'tx': 17, 'success': 7, 'collisions': 10}, {'tx': 4, 'success': 0, 'collisions': 4}, {'tx': 12, 'success': 4, 'collisions': 8}, {'tx': 13, 'success': 8, 'collisions': 5}]"
266,40,67,287,67,220,0.7665505226480837,0.23344947735191637,0.4489,"[{'tx': 7, 'success': 2, 'collisions': 5}, {'tx': 11, 'success': 3, 'collisions': 8}, {'tx': 9, 'success': 3, 'collisions': 6}, {'tx': 4, 'success': 0, 'collisions': 4}, {'tx': 4, 'success': 0, 'collisions': 4}, {'tx': 11, 'success': 4, 'collisions': 7}, {'tx': 9, 'success': 4, 'collisions': 5}, {'tx': 9, 'success': 2, 'collisions': 7}, {'tx': 7, 'success': 1, 'collisions': 6}, {'tx': 4, 'success': 0, 'collisions': 4}, {'tx': 12, 'success': 4, 'collisions': 8}, {'tx': 10, 'success': 4, 'collisions': 6}, {'tx': 4, 'success': 0, 'collisions': 4}, {'tx': 5, 'success': 0, 'collisions': 5}, {'tx': 8, 'success': 2, 'collisions': 6}, {'tx': 8, 'success': 1, 'collisions': 7}, {'tx': 4, 'success': 0, 'collisions': 4}, {'tx': 5, 'success': 1, 'collisions': 4}, {'tx': 10, 'success': 2, 'collisions': 8}, {'tx': 4, 'success': 0, 'collisions': 4}, {'tx': 4, 'success': 0, 'collisions': 4}, {'tx': 5, 'success': 0, 'collisions': 5}, {'tx': 4, 'success': 0, 'collisions': 4}, {'tx': 7, 'success': 2, 'collisions': 5}, {'tx': 11, 'success': 3, 'collisions': 8}, {'tx': 10, 'success': 1, 'collisions': 9}, {'tx': 18, 'success': 10, 'collisions': 8}, {'tx': 10, 'success': 3, 'collisions': 7}, {'tx': 6, 'success': 1, 'collisions': 5}, {'tx': 7, 'success': 2, 'collisions': 5}, {'tx': 7, 'success': 3, 'collisions': 4}, {'tx': 4, 'success': 0, 'collisions': 4}, {'tx': 7, 'success': 2, 'collisions': 5}, {'tx': 4, 'success': 0, 'collisions': 4}, {'tx': 5, 'success': 0, 'collisions': 5}, {'tx': 4, 'success': 0, 'collisions': 4}, {'tx': 5, 'success': 1, 'collisions': 4}, {'tx': 10, 'success': 3, 'collisions': 7}, {'tx': 5, 'success': 1, 'collisions': 4}, {'tx': 9, 'success': 2, 'collisions': 7}]"
267,40,68,285,64,221,0.775438596491228,0.22456140350877193,0.4352,"[{'tx': 8, 'success': 2, 'collisions': 6}, {'tx': 7, 'success': 2, 'collisions': 5}, {'tx': 13, 'success': 5, 'collisions': 8}, {'tx': 7, 'success': 1, 'collisions': 6}, {'tx': 6, 'success': 1, 'collisions': 5}, {'tx': 4, 'success': 0, 'collisions': 4}, {'tx': 10, 'success': 3, 'collisions': 7}, {'tx': 7, 'success': 2, 'collisions': 5}, {'tx': 7, 'success': 1, 'collisions': 6}, {'tx': 8, 'success': 1, 'collisions': 7}, {'tx': 4, 'success': 0, 'collisions': 4}, {'tx': 4, 'success': 0, 'collisions': 4}, {'tx': 7, 'success': 1, 'collisions': 6}, {'tx': 19, 'success': 11, 'collisions': 8}, {'tx': 4, 'success': 0, 'collisions': 4}, {'tx': 10, 'success': 2, 'collisions': 8}, {'tx': 6, 'success': 2, 'collisions': 4}, {'tx': 4, 'success': 0, 'collisions': 4}, {'tx': 5, 'success': 0, 'collisions': 5}, {'tx': 5, 'success': 0, 'collisions': 5}, {'tx': 12, 'success': 5, 'collisions': 7}, {'tx': 10, 'success': 2, 'collisions': 8}, {'tx': 6, 'success': 1, 'collisions': 5}, {'tx': 4, 'success': 0, 'collisions': 4}, {'tx': 7, 'success': 1, 'collisions': 6}, {'tx': 8, 'success': 3, 'collisions': 5}, {'tx': 9, 'success': 1, 'collisions': 8}, {'tx': 5, 'success': 0, 'collisions': 5}, {'tx': 4, 'success': 0, 'collisions': 4}, {'tx': 7, 'success': 1, 'collisions': 6}, {'tx': 6, 'success': 1, 'collisions': 5}, {'tx': 14, 'success': 7, 'collisions': 7}, {'tx': 6, 'success': 1, 'collisions': 5}, {'tx': 8, 'success': 2, 'collisions': 6}, {'tx': 6, 'success': 1, 'collisions': 5}, {'tx': 5, 'success': 0, 'collisions': 5}, {'tx': 5, 'success': 0, 'collisions': 5}, {'tx': 8, 'success': 3, 'collisions': 5}, {'tx': 6, 'success': 1, 'collisions': 5}, {'tx': 4, 'success': 0, 'collisions': 4}]"
268,40,69,283,64,219,0.773851590106007,0.22614840989399293,0.4416,"[{'tx': 4, 'success': 0, 'collisions': 4}, {'tx': 4, 'success': 0, 'collisions': 4}, {'tx': 5, 'success': 0, 'collisions': 5}, {'tx': 5, 'success': 0, 'collisions': 5}, {'tx': 4, 'success': 0, 'collisions': 4}, {'tx': 6, 'success': 1, 'collisions': 5}, {'tx': 7, 'success': 2, 'collisions': 5}, {'tx': 9, 'success': 2, 'collisions': 7}, {'tx': 9, 'success': 3, 'collisions': 6}, {'tx': 13, 'success': 5, 'collisions': 8}, {'tx': 4, 'success': 0, 'collisions': 4}, {'tx': 9, 'success': 3, 'collisions': 6}, {'tx': 11, 'success': 4, 'collisions': 7}, {'tx': 12, 'success': 4, 'collisions': 8}, {'tx': 4, 'success': 0, 'collisions': 4}, {'tx': 7, 'success': 2, 'collisions': 5}, {'tx': 11, 'success': 4, 'collisions': 7}, {'tx': 4, 'success': 0, 'collisions': 4}, {'tx': 4, 'success': 0, 'collisions': 4}, {'tx': 5, 'success': 0, 'collisions': 5}, {'tx': 7, 'success': 2, 'collisions': 5}, {'tx': 5, 'success': 0, 'collisions': 5}, {'tx': 5, 'success': 0, 'collisions': 5}, {'tx': 9, 'success': 3, 'collisions': 6}, {'tx': 10, 'success': 3, 'collisions': 7}, {'tx': 7, 'success': 1, 'collisions': 6}, {'tx': 16, 'success': 6, 'collisions': 10}, {'tx': 4, 'success': 0, 'collisions': 4}, {'tx': 14, 'success': 6, 'collisions': 8}, {'tx': 4, 'success': 0, 'collisions': 4}, {'tx': 9, 'success': 2, 'collisions': 7}, {'tx': 7, 'success': 2, 'collisions': 5}, {'tx': 4, 'success': 0, 'collisions': 4}, {'tx': 16, 'success': 7, 'collisions': 9}, {'tx': 5, 'success': 0, 'collisions': 5}, {'tx': 4, 'success': 0, 'collisions': 4}, {'tx': 4, 'success': 0, 'collisions': 4}, {'tx': 4, 'success': 0, 'collisions': 4}, {'tx': 8, 'success': 2, 'collisions': 6}, {'tx': 4, 'success': 0, 'collisions': 4}]"
269,40,70,269,64,205,0.7620817843866171,0.2379182156133829,0.448,"[{'tx': 4, 'success': 0, 'collisions': 4}, {'tx': 12, 'success': 3, 'collisions': 9}, {'tx': 5, 'success': 1, 'collisions': 4}, {'tx': 9, 'success': 3, 'collisions': 6}, {'tx': 4, 'success': 0, 'collisions': 4}, {'tx': 6, 'success': 1, 'collisions': 5}, {'tx': 5, 'success': 0, 'collisions': 5}, {'tx': 7, 'success': 2, 'collisions': 5}, {'tx': 4, 'success': 0, 'collisions': 4}, {'tx': 5, 'success': 1, 'collisions': 4}, {'tx': 4, 'success': 0, 'collisions': 4}, {'tx': 5, 'success': 0, 'collisions': 5}, {'tx': 4, 'success': 0, 'collisions': 4}, {'tx': 4, 'success': 0, 'collisions': 4}, {'tx': 10, 'success': 4, 'collisions': 6}, {'tx': 4, 'success': 0, 'collisions': 4}, {'tx': 11, 'success': 4, 'collisions': 7}, {'tx': 3, 'success': 0, 'collisions': 3}, {'tx': 15, 'success': 7, 'collisions': 8}, {'tx': 7, 'success': 2, 'collisions': 5}, {'tx': 10, 'success': 5, 'collisions': 5}, {'tx': 4, 'success': 0, 'collisions': 4}, {'tx': 4, 'success': 0, 'collisions': 4}, {'tx': 14, 'success': 5, 'collisions': 9}, {'tx': 11, 'success': 2, 'collisions': 9}, {'tx': 7, 'success': 1, 'collisions': 6}, {'tx': 4, 'success': 0, 'collisions': 4}, {'tx': 4, 'success': 0, 'collisions': 4}, {'tx': 4, 'success': 0, 'collisions': 4}, {'tx': 10, 'success': 4, 'collisions': 6}, {'tx': 15, 'success': 10, 'collisions': 5}, {'tx': 5, 'success': 0, 'collisions': 5}, {'tx': 9, 'success': 2, 'collisions': 7}, {'tx': 5, 'success': 0, 'collisions': 5}, {'tx': 6, 'success': 1, 'collisions': 5}, {'tx': 9, 'success': 3, 'collisions': 6}, {'tx': 6, 'success': 2, 'collisions': 4}, {'tx': 4, 'success': 0, 'collisions': 4}, {'tx': 4, 'success': 0, 'collisions': 4}, {'tx': 6, 'success': 1, 'collisions': 5}]"
270,40,71,280,67,213,0.7607142857142857,0.2392857142857143,0.4757,"[{'tx': 8, 'success': 2, 'collisions': 6}, {'tx': 6, 'success': 1, 'collisions': 5}, {'tx': 14, 'success': 7, 'collisions': 7}, {'tx': 8, 'success': 2, 'collisions': 6}, {'tx': 6, 'success': 1, 'collisions': 5}, {'tx': 4, 'success': 0, 'collisions': 4}, {'tx': 7, 'success': 2, 'collisions': 5}, {'tx': 4, 'success': 0, 'collisions': 4}, {'tx': 7, 'success': 1, 'collisions': 6}, {'tx': 4, 'success': 0, 'collisions': 4}, {'tx': 5, 'success': 0, 'collisions': 5}, {'tx': 7, 'success': 1, 'collisions': 6}, {'tx': 8, 'success': 2, 'collisions': 6}, {'tx': 10, 'success': 4, 'collisions': 6}, {'tx': 9, 'success': 3, 'collisions': 6}, {'tx': 5, 'success': 0, 'collisions': 5}, {'tx': 3, 'success': 0, 'collisions': 3}, {'tx': 15, 'success': 6, 'collisions': 9}, {'tx': 11, 'success': 4, 'collisions': 7}, {'tx': 5, 'success': 0, 'collisions': 5}, {'tx': 5, 'success': 0, 'collisions': 5}, {'tx': 4, 'success': 0, 'collisions': 4}, {'tx': 8, 'success': 2, 'collisions': 6}, {'tx': 4, 'success': 0, 'collisions': 4}, {'tx': 6, 'success': 1, 'collisions': 5}, {'tx': 7, 'success': 1, 'collisions': 6}, {'tx': 4, 'success': 0, 'collisions': 4}, {'tx': 5, 'success': 0, 'collisions': 5}, {'tx': 12, 'success': 5, 'collisions': 7}, {'tx': 6, 'success': 1, 'collisions': 5}, {'tx': 13, 'success': 6, 'collisions': 7}, {'tx': 7, 'success': 2, 'collisions': 5}, {'tx': 5, 'success': 2, 'collisions': 3}, {'tx': 4, 'success': 0, 'collisions': 4}, {'tx': 4, 'success': 0, 'collisions': 4}, {'tx': 5, 'success': 0, 'collisions': 5}, {'tx': 7, 'success': 2, 'collisions': 5}, {'tx': 10, 'success': 4, 'collisions': 6}, {'tx': 10, 'success': 4, 'collisions': 6}, {'tx': 8, 'success': 1, 'collisions': 7}]"
271,40,72,277,66,211,0.7617328519855595,0.23826714801444043,0.4752,"[{'tx': 12, 'success': 3, 'collisions': 9}, {'tx': 3, 'success': 0, 'collisions': 3}, {'tx': 12, 'success': 6, 'collisions': 6}, {'tx': 8, 'success': 2, 'collisions': 6}, {'tx': 4, 'success': 0, 'collisions': 4}, {'tx': 7, 'success': 1, 'collisions': 6}, {'tx': 12, 'success': 3, 'collisions': 9}, {'tx': 10, 'success': 2, 'collisions': 8}, {'tx': 6, 'success': 1, 'collisions': 5}, {'tx': 4, 'success': 0, 'collisions': 4}, {'tx': 10, 'success': 4, 'collisions': 6}, {'tx': 5, 'success': 2, 'collisions': 3}, {'tx': 5, 'success': 1, 'collisions': 4}, {'tx': 11, 'success': 5, 'collisions': 6}, {'tx': 10, 'success': 4, 'collisions': 6}, {'tx': 12, 'success': 5, 'collisions': 7}, {'tx': 4, 'success': 0, 'collisions': 4}, {'tx': 9, 'success': 2, 'collisions': 7}, {'tx': 9, 'success': 3, 'collisions': 6}, {'tx': 4, 'success': 0, 'collisions': 4}, {'tx': 4, 'success': 0, 'collisions': 4}, {'tx': 7, 'success': 2, 'collisions': 5}, {'tx': 9, 'success': 1, 'collisions': 8}, {'tx': 8, 'success': 1, 'collisions': 7}, {'tx': 6, 'success': 2, 'collisions': 4}, {'tx': 7, 'success': 1, 'collisions': 6}, {'tx': 11, 'success': 4, 'collisions': 7}, {'tx': 4, 'success': 0, 'collisions': 4}, {'tx': 4, 'success': 0, 'collisions': 4}, {'tx': 4, 'success': 0, 'collisions': 4}, {'tx': 3, 'success': 0, 'collisions': 3}, {'tx': 6, 'success': 1, 'collisions': 5}, {'tx': 4, 'success': 0, 'collisions': 4}, {'tx': 4, 'success': 0, 'collisions': 4}, {'tx': 4, 'success': 0, 'collisions': 4}, {'tx': 6, 'success': 1, 'collisions': 5}, {'tx': 7, 'success': 1, 'collisions': 6}, {'tx': 10, 'success': 4, 'collisions': 6}, {'tx': 4, 'success': 0, 'collisions': 4}, {'tx': 8, 'success': 4, 'collisions': 4}]"
272,40,73,266,60,206,0.7744360902255639,0.22556390977443608,0.438,"[{'tx': 4, 'success': 0, 'collisions': 4}, {'tx': 6, 'success': 1, 'collisions': 5}, {'tx': 4, 'success': 0, 'collisions': 4}, {'tx': 4, 'success': 0, 'collisions': 4}, {'tx': 14, 'success': 5, 'collisions': 9}, {'tx': 10, 'success': 3, 'collisions': 7}, {'tx': 6, 'success': 1, 'collisions': 5}, {'tx': 4, 'success': 0, 'collisions': 4}, {'tx': 10, 'success': 4, 'collisions': 6}, {'tx': 9, 'success': 3, 'collisions': 6}, {'tx': 3, 'success': 0, 'collisions': 3}, {'tx': 7, 'success': 1, 'collisions': 6}, {'tx': 4, 'success': 0, 'collisions': 4}, {'tx': 7, 'success': 1, 'collisions': 6}, {'tx': 6, 'success': 1, 'collisions': 5}, {'tx': 13, 'success': 6, 'collisions': 7}, {'tx': 4, 'success': 0, 'collisions': 4}, {'tx': 4, 'success': 0, 'collisions': 4}, {'tx': 4, 'success': 0, 'collisions': 4}, {'tx': 9, 'success': 2, 'collisions': 7}, {'tx': 4, 'success': 0, 'collisions': 4}, {'tx': 11, 'success': 3, 'collisions': 8}, {'tx': 4, 'success': 0, 'collisions': 4}, {'tx': 3, 'success': 0, 'collisions': 3}, {'tx': 3, 'success': 0, 'collisions': 3}, {'tx': 4, 'success': 0, 'collisions': 4}, {'tx': 7, 'success': 1, 'collisions': 6}, {'tx': 7, 'success': 1, 'collisions': 6}, {'tx': 6, 'success': 1, 'collisions': 5}, {'tx': 7, 'success': 2, 'collisions': 5}, {'tx': 4, 'success': 0, 'collisions': 4}, {'tx': 5, 'success': 0, 'collisions': 5}, {'tx': 10, 'success': 4, 'collisions': 6}, {'tx': 4, 'success': 0, 'collisions': 4}, {'tx': 14, 'success': 7, 'collisions': 7}, {'tx': 6, 'success': 1, 'collisions': 5}, {'tx': 5, 'success': 0, 'collisions': 5}, {'tx': 7, 'success': 1, 'collisions': 6}, {'tx': 15, 'success': 9, 'collisions': 6}, {'tx': 8, 'success': 2, 'collisions': 6}]"
273,40,74,256,63,193,0.75390625,0.24609375,0.4662,"[{'tx': 12, 'success': 4, 'collisions': 8}, {'tx': 9, 'success': 3, 'collisions': 6}, {'tx': 3, 'success': 0, 'collisions': 3}, {'tx': 9, 'success': 5, 'collisions': 4}, {'tx': 9, 'success': 2, 'collisions': 7}, {'tx': 8, 'success': 2, 'collisions': 6}, {'tx': 4, 'success': 0, 'collisions': 4}, {'tx': 9, 'success': 4, 'collisions': 5}, {'tx': 4, 'success': 0, 'collisions': 4}, {'tx': 4, 'success': 0, 'collisions': 4}, {'tx': 4, 'success': 0, 'collisions': 4}, {'tx': 8, 'success': 1, 'collisions': 7}, {'tx': 8, 'success': 2, 'collisions': 6}, {'tx': 4, 'success': 0, 'collisions': 4}, {'tx': 9, 'success': 4, 'collisions': 5}, {'tx': 12, 'success': 6, 'collisions': 6}, {'tx': 12, 'success': 4, 'collisions': 8}, {'tx': 4, 'success': 0, 'collisions': 4}, {'tx': 6, 'success': 1, 'collisions': 5}, {'tx': 4, 'success': 0, 'collisions': 4}, {'tx': 9, 'success': 4, 'collisions': 5}, {'tx': 4, 'success': 0, 'collisions': 4}, {'tx': 6, 'success': 1, 'collisions': 5}, {'tx': 6, 'success': 2, 'collisions': 4}, {'tx': 4, 'success': 0, 'collisions': 4}, {'tx': 7, 'success': 2, 'collisions': 5}, {'tx': 4, 'success': 0, 'collisions': 4}, {'tx': 3, 'success': 0, 'collisions': 3}, {'tx': 5, 'success': 1, 'collisions': 4}, {'tx': 7, 'success': 2, 'collisions': 5}, {'tx': 5, 'success': 0, 'collisions': 5}, {'tx': 8, 'success': 2, 'collisions': 6}, {'tx': 12, 'success': 6, 'collisions': 6}, {'tx': 6, 'success': 1, 'collisions': 5}, {'tx': 4, 'success': 0, 'collisions': 4}, {'tx': 4, 'success': 0, 'collisions': 4}, {'tx': 5, 'success': 1, 'collisions': 4}, {'tx': 4, 'success': 0, 'collisions': 4}, {'tx': 7, 'success': 3, 'collisions': 4}, {'tx': 4, 'success': 0, 'collisions': 4}]"
274,40,75,265,60,205,0.7735849056603774,0.22641509433962265,0.45,"[{'tx': 4, 'success': 0, 'collisions': 4}, {'tx': 4, 'success': 0, 'collisions': 4}, {'tx': 13, 'success': 4, 'collisions': 9}, {'tx': 4, 'success': 0, 'collisions': 4}, {'tx': 11, 'success': 4, 'collisions': 7}, {'tx': 6, 'success': 1, 'collisions': 5}, {'tx': 8, 'success': 2, 'collisions': 6}, {'tx': 7, 'success': 2, 'collisions': 5}, {'tx': 13, 'success': 5, 'collisions': 8}, {'tx': 5, 'success': 0, 'collisions': 5}, {'tx': 3, 'success': 0, 'collisions': 3}, {'tx': 15, 'success': 6, 'collisions': 9}, {'tx': 4, 'success': 0, 'collisions': 4}, {'tx': 7, 'success': 2, 'collisions': 5}, {'tx': 5, 'success': 1, 'collisions': 4}, {'tx': 3, 'success': 0, 'collisions': 3}, {'tx': 12, 'success': 5, 'collisions': 7}, {'tx': 14, 'success': 6, 'collisions': 8}, {'tx': 9, 'success': 3, 'collisions': 6}, {'tx': 10, 'success': 3, 'collisions': 7}, {'tx': 8, 'success': 2, 'collisions': 6}, {'tx': 4, 'success': 0, 'collisions': 4}, {'tx': 6, 'success': 1, 'collisions': 5}, {'tx': 3, 'success': 0, 'collisions': 3}, {'tx': 3, 'success': 0, 'collisions': 3}, {'tx': 7, 'success': 2, 'collisions': 5}, {'tx': 5, 'success': 1, 'collisions': 4}, {'tx': 6, 'success': 1, 'collisions': 5}, {'tx': 4, 'success': 0, 'collisions': 4}, {'tx': 3, 'success': 0, 'collisions': 3}, {'tx': 4, 'success': 0, 'collisions': 4}, {'tx': 5, 'success': 0, 'collisions': 5}, {'tx': 6, 'success': 0, 'collisions': 6}, {'tx': 5, 'success': 0, 'collisions': 5}, {'tx': 4, 'success': 0, 'collisions': 4}, {'tx': 11, 'success': 4, 'collisions': 7}, {'tx': 4, 'success': 0, 'collisions': 4}, {'tx': 4, 'success': 0, 'collisions': 4}, {'tx': 9, 'success': 3, 'collisions': 6}, {'tx': 7, 'success': 2, 'collisions': 5}]"
275,40,76,258,62,196,0.7596899224806202,0.24031007751937986,0.4712,"[{'tx': 11, 'success': 5, 'collisions': 6}, {'tx': 9, 'success': 3, 'collisions': 6}, {'tx': 5, 'success': 1, 'collisions': 4}, {'tx': 11, 'success': 5, 'collisions': 6}, {'tx': 6, 'success': 1, 'collisions': 5}, {'tx': 4, 'success': 0, 'collisions': 4}, {'tx': 4, 'success': 0, 'collisions': 4}, {'tx': 4, 'success': 0, 'collisions': 4}, {'tx': 3, 'success': 0, 'collisions': 3}, {'tx': 5, 'success': 0, 'collisions': 5}, {'tx': 3, 'success': 0, 'collisions': 3}, {'tx': 9, 'success': 2, 'collisions': 7}, {'tx': 4, 'success': 1, 'collisions': 3}, {'tx': 3, 'success': 0, 'collisions': 3}, {'tx': 6, 'success': 1, 'collisions': 5}, {'tx': 9, 'success': 1, 'collisions': 8}, {'tx': 8, 'success': 3, 'collisions': 5}, {'tx': 8, 'success': 2, 'collisions': 6}, {'tx': 9, 'success': 2, 'collisions': 7}, {'tx': 4, 'success': 0, 'collisions': 4}, {'tx': 4, 'success': 0, 'collisions': 4}, {'tx': 9, 'success': 3, 'collisions': 6}, {'tx': 4, 'success': 0, 'collisions': 4}, {'tx': 8, 'success': 2, 'collisions': 6}, {'tx': 8, 'success': 3, 'collisions': 5}, {'tx': 3, 'success': 0, 'collisions': 3}, {'tx': 4, 'success': 0, 'collisions': 4}, {'tx': 8, 'success': 2, 'collisions': 6}, {'tx': 9, 'success': 3, 'collisions': 6}, {'tx': 14, 'success': 6, 'collisions': 8}, {'tx': 4, 'success': 0, 'collisions': 4}, {'tx': 4, 'success': 0, 'collisions': 4}, {'tx': 10, 'success': 4, 'collisions': 6}, {'tx': 7, 'success': 2, 'collisions': 5}, {'tx': 8, 'success': 3, 'collisions': 5}, {'tx': 12, 'success': 5, 'collisions': 7}, {'tx': 3, 'success': 0, 'collisions': 3}, {'tx': 5, 'success': 1, 'collisions': 4}, {'tx': 3, 'success': 0, 'collisions': 3}, {'tx': 6, 'success': 1, 'collisions': 5}]"
276,40,77,243,62,181,0.7448559670781894,0.2551440329218107,0.4774,"[{'tx': 5, 'success': 1, 'collisions': 4}, {'tx': 4, 'success': 1, 'collisions': 3}, {'tx': 5, 'success': 0, 'collisions': 5}, {'tx': 5, 'success': 2, 'collisions': 3}, {'tx': 10, 'success': 3, 'collisions': 7}, {'tx': 4, 'success': 0, 'collisions': 4}, {'tx': 8, 'success': 2, 'collisions': 6}, {'tx': 4, 'success': 0, 'collisions': 4}, {'tx': 4, 'success': 0, 'collisions': 4}, {'tx': 6, 'success': 1, 'collisions': 5}, {'tx': 8, 'success': 2, 'collisions': 6}, {'tx': 5, 'success': 0, 'collisions': 5}, {'tx': 4, 'success': 0, 'collisions': 4}, {'tx': 8, 'success': 4, 'collisions': 4}, {'tx': 6, 'success': 2, 'collisions': 4}, {'tx': 4, 'success': 0, 'collisions': 4}, {'tx': 4, 'success': 1, 'collisions': 3}, {'tx': 4, 'success': 0, 'collisions': 4}, {'tx': 4, 'success': 0, 'collisions': 4}, {'tx': 11, 'success': 4, 'collisions': 7}, {'tx': 5, 'success': 1, 'collisions': 4}, {'tx': 9, 'success': 4, 'collisions': 5}, {'tx': 13, 'success': 6, 'collisions': 7}, {'tx': 7, 'success': 2, 'collisions': 5}, {'tx': 7, 'success': 1, 'collisions': 6}, {'tx': 4, 'success': 0, 'collisions': 4}, {'tx': 4, 'success': 0, 'collisions': 4}, {'tx': 3, 'success': 0, 'collisions': 3}, {'tx': 4, 'success': 0, 'collisions': 4}, {'tx': 11, 'success': 7, 'collisions': 4}, {'tx': 8, 'success': 2, 'collisions': 6}, {'tx': 4, 'success': 0, 'collisions': 4}, {'tx': 4, 'success': 1, 'collisions': 3}, {'tx': 12, 'success': 7, 'collisions': 5}, {'tx': 10, 'success': 3, 'collisions': 7}, {'tx': 5, 'success': 1, 'collisions': 4}, {'tx': 6, 'success': 2, 'collisions': 4}, {'tx': 5, 'success': 1, 'collisions': 4}, {'tx': 3, 'success': 0, 'collisions': 3}, {'tx': 6, 'success': 1, 'collisions': 5}]"
277,40,78,255,58,197,0.7725490196078432,0.22745098039215686,0.4524,"[{'tx': 7, 'success': 2, 'collisions': 5}, {'tx': 4, 'success': 0, 'collisions': 4}, {'tx': 4, 'success': 0, 'collisions': 4}, {'tx': 4, 'success': 0, 'collisions': 4}, {'tx': 4, 'success': 0, 'collisions': 4}, {'tx': 11, 'success': 4, 'collisions': 7}, {'tx': 5, 'success': 1, 'collisions': 4}, {'tx': 5, 'success': 0, 'collisions': 5}, {'tx': 6, 'success': 2, 'collisions': 4}, {'tx': 4, 'success': 0, 'collisions': 4}, {'tx': 4, 'success': 0, 'collisions': 4}, {'tx': 5, 'success': 0, 'collisions': 5}, {'tx': 9, 'success': 2, 'collisions': 7}, {'tx': 3, 'success': 0, 'collisions': 3}, {'tx': 6, 'success': 1, 'collisions': 5}, {'tx': 10, 'success': 4, 'collisions': 6}, {'tx': 7, 'success': 1, 'collisions': 6}, {'tx': 8, 'success': 2, 'collisions': 6}, {'tx': 10, 'success': 4, 'collisions': 6}, {'tx': 11, 'success': 7, 'collisions': 4}, {'tx': 11, 'success': 5, 'collisions': 6}, {'tx': 10, 'success': 4, 'collisions': 6}, {'tx': 9, 'success': 3, 'collisions': 6}, {'tx': 13, 'success': 6, 'collisions': 7}, {'tx': 4, 'success': 0, 'collisions': 4}, {'tx': 7, 'success': 1, 'collisions': 6}, {'tx': 4, 'success': 0, 'collisions': 4}, {'tx': 7, 'success': 1, 'collisions': 6}, {'tx': 8, 'success': 2, 'collisions': 6}, {'tx': 7, 'success': 1, 'collisions': 6}, {'tx': 5, 'success': 1, 'collisions': 4}, {'tx': 8, 'success': 1, 'collisions': 7}, {'tx': 4, 'success': 0, 'collisions': 4}, {'tx': 4, 'success': 0, 'collisions': 4}, {'tx': 4, 'success': 1, 'collisions': 3}, {'tx': 4, 'success': 0, 'collisions': 4}, {'tx': 4, 'success': 0, 'collisions': 4}, {'tx': 4, 'success': 0, 'collisions': 4}, {'tx': 5, 'success': 1, 'collisions': 4}, {'tx': 6, 'success': 1, 'collisions': 5}]"
278,40,79,244,60,184,0.7540983606557377,0.2459016393442623,0.474,"[{'tx': 7, 'success': 2, 'collisions': 5}, {'tx': 4, 'success': 0, 'collisions': 4}, {'tx': 8, 'success': 3, 'collisions': 5}, {'tx': 4, 'success': 0, 'collisions': 4}, {'tx': 8, 'success': 3, 'collisions': 5}, {'tx': 4, 'success': 0, 'collisions': 4}, {'tx': 8, 'success': 4, 'collisions': 4}, {'tx': 4, 'success': 0, 'collisions': 4}, {'tx': 7, 'success': 1, 'collisions': 6}, {'tx': 13, 'success': 6, 'collisions': 7}, {'tx': 3, 'success': 0, 'collisions': 3}, {'tx': 4, 'success': 0, 'collisions': 4}, {'tx': 4, 'success': 0, 'collisions': 4}, {'tx': 3, 'success': 0, 'collisions': 3}, {'tx': 9, 'success': 5, 'collisions': 4}, {'tx': 4, 'success': 0, 'collisions': 4}, {'tx': 12, 'success': 5, 'collisions': 7}, {'tx': 8, 'success': 3, 'collisions': 5}, {'tx': 4, 'success': 0, 'collisions': 4}, {'tx': 9, 'success': 4, 'collisions': 5}, {'tx': 9, 'success': 4, 'collisions': 5}, {'tx': 4, 'success': 0, 'collisions': 4}, {'tx': 6, 'success': 2, 'collisions': 4}, {'tx': 9, 'success': 3, 'collisions': 6}, {'tx': 6, 'success': 1, 'collisions': 5}, {'tx': 7, 'success': 2, 'collisions': 5}, {'tx': 4, 'success': 0, 'collisions': 4}, {'tx': 6, 'success': 1, 'collisions': 5}, {'tx': 7, 'success': 1, 'collisions': 6}, {'tx': 4, 'success': 0, 'collisions': 4}, {'tx': 6, 'success': 2, 'collisions': 4}, {'tx': 4, 'success': 0, 'collisions': 4}, {'tx': 6, 'success': 1, 'collisions': 5}, {'tx': 4, 'success': 0, 'collisions': 4}, {'tx': 6, 'success': 2, 'collisions': 4}, {'tx': 4, 'success': 0, 'collisions': 4}, {'tx': 9, 'success': 2, 'collisions': 7}, {'tx': 4, 'success': 0, 'collisions': 4}, {'tx': 4, 'success': 0, 'collisions': 4}, {'tx': 8, 'success': 3, 'collisions': 5}]"
279,40,80,245,59,186,0.7591836734693878,0.24081632653061225,0.472,"[{'tx': 8, 'success': 3, 'collisions': 5}, {'tx': 4, 'success': 0, 'collisions': 4}, {'tx': 3, 'success': 0, 'collisions': 3}, {'tx': 9, 'success': 3, 'collisions': 6}, {'tx': 8, 'success': 2, 'collisions': 6}, {'tx': 9, 'success': 6, 'collisions': 3}, {'tx': 7, 'success': 2, 'collisions': 5}, {'tx': 4, 'success': 0, 'collisions': 4}, {'tx': 3, 'success': 0, 'collisions': 3}, {'tx': 4, 'success': 0, 'collisions': 4}, {'tx': 8, 'success': 2, 'collisions': 6}, {'tx': 3, 'success': 0, 'collisions': 3}, {'tx': 8, 'success': 2, 'collisions': 6}, {'tx': 8, 'success': 1, 'collisions': 7}, {'tx': 4, 'success': 0, 'collisions': 4}, {'tx': 4, 'success': 0, 'collisions': 4}, {'tx': 4, 'success': 0, 'collisions': 4}, {'tx': 4, 'success': 0, 'collisions': 4}, {'tx': 8, 'success': 1, 'collisions': 7}, {'tx': 7, 'success': 2, 'collisions': 5}, {'tx': 9, 'success': 4, 'collisions': 5}, {'tx': 4, 'success': 1, 'collisions': 3}, {'tx': 3, 'success': 0, 'collisions': 3}, {'tx': 6, 'success': 2, 'collisions': 4}, {'tx': 4, 'success': 0, 'collisions': 4}, {'tx': 7, 'success': 2, 'collisions': 5}, {'tx': 5, 'success': 0, 'collisions': 5}, {'tx': 10, 'success': 3, 'collisions': 7}, {'tx': 8, 'success': 2, 'collisions': 6}, {'tx': 5, 'success': 1, 'collisions': 4}, {'tx': 9, 'success': 3, 'collisions': 6}, {'tx': 9, 'success': 4, 'collisions': 5}, {'tx': 4, 'success': 0, 'collisions': 4}, {'tx': 7, 'success': 2, 'collisions': 5}, {'tx': 5, 'success': 2, 'collisions': 3}, {'tx': 10, 'success': 4, 'collisions': 6}, {'tx': 6, 'success': 1, 'collisions': 5}, {'tx': 6, 'success': 2, 'collisions': 4}, {'tx': 3, 'success': 0, 'collisions': 3}, {'tx': 8, 'success': 2, 'collisions': 6}]"
280,40,81,241,55,186,0.7717842323651453,0.22821576763485477,0.4455,"[{'tx': 6, 'success': 1, 'collisions': 5}, {'tx': 4, 'success': 0, 'collisions': 4}, {'tx': 4, 'success': 0, 'collisions': 4}, {'tx': 7, 'success': 2, 'collisions': 5}, {'tx': 10, 'success': 2, 'collisions': 8}, {'tx': 6, 'success': 1, 'collisions': 5}, {'tx': 6, 'success': 1, 'collisions': 5}, {'tx': 10, 'success': 5, 'collisions': 5}, {'tx': 4, 'success': 0, 'collisions': 4}, {'tx': 6, 'success': 1, 'collisions': 5}, {'tx': 4, 'success': 0, 'collisions': 4}, {'tx': 5, 'success': 0, 'collisions': 5}, {'tx': 9, 'success': 3, 'collisions': 6}, {'tx': 6, 'success': 2, 'collisions': 4}, {'tx': 8, 'success': 1, 'collisions': 7}, {'tx': 4, 'success': 0, 'collisions': 4}, {'tx': 3, 'success': 0, 'collisions': 3}, {'tx': 4, 'success': 0, 'collisions': 4}, {'tx': 4, 'success': 0, 'collisions': 4}, {'tx': 8, 'success': 2, 'collisions': 6}, {'tx': 5, 'success': 0, 'collisions': 5}, {'tx': 5, 'success': 1, 'collisions': 4}, {'tx': 7, 'success': 3, 'collisions': 4}, {'tx': 7, 'success': 1, 'collisions': 6}, {'tx': 4, 'success': 0, 'collisions': 4}, {'tx': 4, 'success': 0, 'collisions': 4}, {'tx': 13, 'success': 7, 'collisions': 6}, {'tx': 3, 'success': 0, 'collisions': 3}, {'tx': 9, 'success': 4, 'collisions': 5}, {'tx': 6, 'success': 1, 'collisions': 5}, {'tx': 3, 'success': 0, 'collisions': 3}, {'tx': 7, 'success': 2, 'collisions': 5}, {'tx': 11, 'success': 5, 'collisions': 6}, {'tx': 8, 'success': 2, 'collisions': 6}, {'tx': 7, 'success': 2, 'collisions': 5}, {'tx': 7, 'success': 3, 'collisions': 4}, {'tx': 4, 'success': 0, 'collisions': 4}, {'tx': 4, 'success': 1, 'collisions': 3}, {'tx': 6, 'success': 2, 'collisions': 4}, {'tx': 3, 'success': 0, 'collisions': 3}]"
281,40,82,235,60,175,0.7446808510638298,0.2553191489361702,0.492,"[{'tx': 4, 'success': 0, 'collisions': 4}, {'tx': 8, 'success': 3, 'collisions': 5}, {'tx': 3, 'success': 0, 'collisions': 3}, {'tx': 7, 'success': 2, 'collisions': 5}, {'tx': 7, 'success': 1, 'collisions': 6}, {'tx': 3, 'success': 0, 'collisions': 3}, {'tx': 3, 'success': 0, 'collisions': 3}, {'tx': 5, 'success': 0, 'collisions': 5}, {'tx': 4, 'success': 0, 'collisions': 4}, {'tx': 3, 'success': 0, 'collisions': 3}, {'tx': 3, 'success': 0, 'collisions': 3}, {'tx': 9, 'success': 4, 'collisions': 5}, {'tx': 3, 'success': 0, 'collisions': 3}, {'tx': 3, 'success': 0, 'collisions': 3}, {'tx': 7, 'success': 2, 'collisions': 5}, {'tx': 8, 'success': 3, 'collisions': 5}, {'tx': 6, 'success': 2, 'collisions': 4}, {'tx': 12, 'success': 6, 'collisions': 6}, {'tx': 9, 'success': 4, 'collisions': 5}, {'tx': 4, 'success': 0, 'collisions': 4}, {'tx': 4, 'success': 0, 'collisions': 4}, {'tx': 4, 'success': 0, 'collisions': 4}, {'tx': 4, 'success': 0, 'collisions': 4}, {'tx': 3, 'success': 0, 'collisions': 3}, {'tx': 6, 'success': 1, 'collisions': 5}, {'tx': 4, 'success': 0, 'collisions': 4}, {'tx': 8, 'success': 4, 'collisions': 4}, {'tx': 4, 'success': 0, 'collisions': 4}, {'tx': 9, 'success': 4, 'collisions': 5}, {'tx': 10, 'success': 4, 'collisions': 6}, {'tx': 7, 'success': 2, 'collisions': 5}, {'tx': 8, 'success': 4, 'collisions': 4}, {'tx': 3, 'success': 0, 'collisions': 3}, {'tx': 7, 'success': 2, 'collisions': 5}, {'tx': 8, 'success': 1, 'collisions': 7}, {'tx': 6, 'success': 1, 'collisions': 5}, {'tx': 9, 'success': 5, 'collisions': 4}, {'tx': 8, 'success': 3, 'collisions': 5}, {'tx': 5, 'success': 1, 'collisions': 4}, {'tx': 7, 'success': 1, 'collisions': 6}]"
282,40,83,237,54,183,0.7721518987341772,0.22784810126582278,0.4482,"[{'tx': 5, 'success': 1, 'collisions': 4}, {'tx': 11, 'success': 5, 'collisions': 6}, {'tx': 11, 'success': 5, 'collisions': 6}, {'tx': 4, 'success': 0, 'collisions': 4}, {'tx': 5, 'success': 1, 'collisions': 4}, {'tx': 9, 'success': 4, 'collisions': 5}, {'tx': 6, 'success': 2, 'collisions': 4}, {'tx': 3, 'success': 0, 'collisions': 3}, {'tx': 3, 'success': 0, 'collisions': 3}, {'tx': 5, 'success': 2, 'collisions': 3}, {'tx': 5, 'success': 1, 'collisions': 4}, {'tx': 4, 'success': 0, 'collisions': 4}, {'tx': 9, 'success': 4, 'collisions': 5}, {'tx': 12, 'success': 5, 'collisions': 7}, {'tx': 4, 'success': 0, 'collisions': 4}, {'tx': 7, 'success': 2, 'collisions': 5}, {'tx': 4, 'success': 0, 'collisions': 4}, {'tx': 4, 'success': 0, 'collisions': 4}, {'tx': 4, 'success': 0, 'collisions': 4}, {'tx': 9, 'success': 2, 'collisions': 7}, {'tx': 5, 'success': 1, 'collisions': 4}, {'tx': 5, 'success': 0, 'collisions': 5}, {'tx': 5, 'success': 1, 'collisions': 4}, {'tx': 3, 'success': 0, 'collisions': 3}, {'tx': 8, 'success': 2, 'collisions': 6}, {'tx': 7, 'success': 1, 'collisions': 6}, {'tx': 4, 'success': 0, 'collisions': 4}, {'tx': 6, 'success': 2, 'collisions': 4}, {'tx': 7, 'success': 2, 'collisions': 5}, {'tx': 7, 'success': 2, 'collisions': 5}, {'tx': 4, 'success': 0, 'collisions': 4}, {'tx': 4, 'success': 0, 'collisions': 4}, {'tx': 4, 'success': 0, 'collisions': 4}, {'tx': 4, 'success': 0, 'collisions': 4}, {'tx': 4, 'success': 0, 'collisions': 4}, {'tx': 12, 'success': 5, 'collisions': 7}, {'tx': 5, 'success': 0, 'collisions': 5}, {'tx': 6, 'success': 1, 'collisions': 5}, {'tx': 4, 'success': 0, 'collisions': 4}, {'tx': 9, 'success': 3, 'collisions': 6}]"
283,40,84,236,54,182,0.7711864406779662,0.2288135593220339,0.4536,"[{'tx': 5, 'success': 1, 'collisions': 4}, {'tx': 3, 'success': 0, 'collisions': 3}, {'tx': 4, 'success': 0, 'collisions': 4}, {'tx': 8, 'success': 3, 'collisions': 5}, {'tx': 4, 'success': 0, 'collisions': 4}, {'tx': 10, 'success': 4, 'collisions': 6}, {'tx': 8, 'success': 2, 'collisions': 6}, {'tx': 4, 'success': 0, 'collisions': 4}, {'tx': 8, 'success': 4, 'collisions': 4}, {'tx': 4, 'success': 0, 'collisions': 4}, {'tx': 8, 'success': 2, 'collisions': 6}, {'tx': 11, 'success': 4, 'collisions': 7}, {'tx': 8, 'success': 3, 'collisions': 5}, {'tx': 8, 'success': 4, 'collisions': 4}, {'tx': 4, 'success': 0, 'collisions': 4}, {'tx': 3, 'success': 0, 'collisions': 3}, {'tx': 9, 'success': 2, 'collisions': 7}, {'tx': 6, 'success': 2, 'collisions': 4}, {'tx': 4, 'success': 0, 'collisions': 4}, {'tx': 4, 'success': 0, 'collisions': 4}, {'tx': 9, 'success': 3, 'collisions': 6}, {'tx': 4, 'success': 0, 'collisions': 4}, {'tx': 5, 'success': 1, 'collisions': 4}, {'tx': 7, 'success': 2, 'collisions': 5}, {'tx': 5, 'success': 1, 'collisions': 4}, {'tx': 11, 'success': 5, 'collisions': 6}, {'tx': 4, 'success': 0, 'collisions': 4}, {'tx': 3, 'success': 0, 'collisions': 3}, {'tx': 7, 'success': 2, 'collisions': 5}, {'tx': 9, 'success': 2, 'collisions': 7}, {'tx': 5, 'success': 1, 'collisions': 4}, {'tx': 5, 'success': 1, 'collisions': 4}, {'tx': 6, 'success': 2, 'collisions': 4}, {'tx': 4, 'success': 0, 'collisions': 4}, {'tx': 5, 'success': 0, 'collisions': 5}, {'tx': 5, 'success': 1, 'collisions': 4}, {'tx': 4, 'success': 0, 'collisions': 4}, {'tx': 4, 'success': 0, 'collisions': 4}, {'tx': 4, 'success': 0, 'collisions': 4}, {'tx': 7, 'success': 2, 'collisions': 5}]"
284,40,85,234,51,183,0.782051282051282,0.21794871794871795,0.4335,"[{'tx': 4, 'success': 0, 'collisions': 4}, {'tx': 3, 'success': 0, 'collisions': 3}, {'tx': 4, 'success': 0, 'collisions': 4}, {'tx': 6, 'success': 1, 'collisions': 5}, {'tx': 5, 'success': 0, 'collisions': 5}, {'tx': 4, 'success': 0, 'collisions': 4}, {'tx': 3, 'success': 0, 'collisions': 3}, {'tx': 10, 'success': 3, 'collisions': 7}, {'tx': 6, 'success': 1, 'collisions': 5}, {'tx': 5, 'success': 1, 'collisions': 4}, {'tx': 6, 'success': 3, 'collisions': 3}, {'tx': 3, 'success': 0, 'collisions': 3}, {'tx': 8, 'success': 3, 'collisions': 5}, {'tx': 3, 'success': 0, 'collisions': 3}, {'tx': 3, 'success': 0, 'collisions': 3}, {'tx': 4, 'success': 0, 'collisions': 4}, {'tx': 7, 'success': 2, 'collisions': 5}, {'tx': 4, 'success': 0, 'collisions': 4}, {'tx': 9, 'success': 4, 'collisions': 5}, {'tx': 7, 'success': 2, 'collisions': 5}, {'tx': 4, 'success': 0, 'collisions': 4}, {'tx': 6, 'success': 1, 'collisions': 5}, {'tx': 8, 'success': 2, 'collisions': 6}, {'tx': 7, 'success': 1, 'collisions': 6}, {'tx': 10, 'success': 4, 'collisions': 6}, {'tx': 8, 'success': 3, 'collisions': 5}, {'tx': 8, 'success': 3, 'collisions': 5}, {'tx': 8, 'success': 2, 'collisions': 6}, {'tx': 10, 'success': 3, 'collisions': 7}, {'tx': 11, 'success': 5, 'collisions': 6}, {'tx': 3, 'success': 0, 'collisions': 3}, {'tx': 4, 'success': 0, 'collisions': 4}, {'tx': 5, 'success': 1, 'collisions': 4}, {'tx': 4, 'success': 0, 'collisions': 4}, {'tx': 8, 'success': 3, 'collisions': 5}, {'tx': 6, 'success': 1, 'collisions': 5}, {'tx': 6, 'success': 1, 'collisions': 5}, {'tx': 4, 'success': 0, 'collisions': 4}, {'tx': 4, 'success': 0, 'collisions': 4}, {'tx': 6, 'success': 1, 'collisions': 5}]"
285,40,86,227,59,168,0.7400881057268722,0.2599118942731278,0.5074,"[{'tx': 3, 'success': 0, 'collisions': 3}, {'tx': 3, 'success': 0, 'collisions': 3}, {'tx': 4, 'success': 0, 'collisions': 4}, {'tx': 4, 'success': 0, 'collisions': 4}, {'tx': 5, 'success': 0, 'collisions': 5}, {'tx': 7, 'success': 3, 'collisions': 4}, {'tx': 3, 'success': 0, 'collisions': 3}, {'tx': 8, 'success': 2, 'collisions': 6}, {'tx': 3, 'success': 0, 'collisions': 3}, {'tx': 6, 'success': 2, 'collisions': 4}, {'tx': 9, 'success': 3, 'collisions': 6}, {'tx': 8, 'success': 2, 'collisions': 6}, {'tx': 4, 'success': 1, 'collisions': 3}, {'tx': 6, 'success': 2, 'collisions': 4}, {'tx': 8, 'success': 3, 'collisions': 5}, {'tx': 8, 'success': 2, 'collisions': 6}, {'tx': 6, 'success': 2, 'collisions': 4}, {'tx': 3, 'success': 0, 'collisions': 3}, {'tx': 7, 'success': 2, 'collisions': 5}, {'tx': 4, 'success': 0, 'collisions': 4}, {'tx': 8, 'success': 4, 'collisions': 4}, {'tx': 5, 'success': 0, 'collisions': 5}, {'tx': 4, 'success': 0, 'collisions': 4}, {'tx': 3, 'success': 0, 'collisions': 3}, {'tx': 3, 'success': 0, 'collisions': 3}, {'tx': 4, 'success': 0, 'collisions': 4}, {'tx': 11, 'success': 6, 'collisions': 5}, {'tx': 8, 'success': 3, 'collisions': 5}, {'tx': 4, 'success': 1, 'collisions': 3}, {'tx': 7, 'success': 3, 'collisions': 4}, {'tx': 7, 'success': 2, 'collisions': 5}, {'tx': 11, 'success': 6, 'collisions': 5}, {'tx': 8, 'success': 3, 'collisions': 5}, {'tx': 8, 'success': 3, 'collisions': 5}, {'tx': 4, 'success': 0, 'collisions': 4}, {'tx': 4, 'success': 0, 'collisions': 4}, {'tx': 9, 'success': 4, 'collisions': 5}, {'tx': 4, 'success': 0, 'collisions': 4}, {'tx': 3, 'success': 0, 'collisions': 3}, {'tx': 3, 'success': 0, 'collisions': 3}]"
286,40,87,226,48,178,0.7876106194690266,0.21238938053097345,0.4176,"[{'tx': 10, 'success': 3, 'collisions': 7}, {'tx': 3, 'success': 0, 'collisions': 3}, {'tx': 6, 'success': 1, 'collisions': 5}, {'tx': 3, 'success': 0, 'collisions': 3}, {'tx': 5, 'success': 0, 'collisions': 5}, {'tx': 4, 'success': 0, 'collisions': 4}, {'tx': 5, 'success': 1, 'collisions': 4}, {'tx': 5, 'success': 1, 'collisions': 4}, {'tx': 4, 'success': 1, 'collisions': 3}, {'tx': 7, 'success': 2, 'collisions': 5}, {'tx': 5, 'success': 1, 'collisions': 4}, {'tx': 5, 'success': 0, 'collisions': 5}, {'tx': 4, 'success': 0, 'collisions': 4}, {'tx': 9, 'success': 4, 'collisions': 5}, {'tx': 7, 'success': 1, 'collisions': 6}, {'tx': 4, 'success': 0, 'collisions': 4}, {'tx': 4, 'success': 0, 'collisions': 4}, {'tx': 5, 'success': 1, 'collisions': 4}, {'tx': 9, 'success': 3, 'collisions': 6}, {'tx': 6, 'success': 2, 'collisions': 4}, {'tx': 3, 'success': 0, 'collisions': 3}, {'tx': 9, 'success': 3, 'collisions': 6}, {'tx': 3, 'success': 0, 'collisions': 3}, {'tx': 4, 'success': 0, 'collisions': 4}, {'tx': 12, 'success': 5, 'collisions': 7}, {'tx': 5, 'success': 1, 'collisions': 4}, {'tx': 7, 'success': 2, 'collisions': 5}, {'tx': 5, 'success': 0, 'collisions': 5}, {'tx': 4, 'success': 0, 'collisions': 4}, {'tx': 5, 'success': 1, 'collisions': 4}, {'tx': 4, 'success': 1, 'collisions': 3}, {'tx': 3, 'success': 0, 'collisions': 3}, {'tx': 5, 'success': 1, 'collisions': 4}, {'tx': 5, 'success': 0, 'collisions': 5}, {'tx': 8, 'success': 3, 'collisions': 5}, {'tx': 5, 'success': 1, 'collisions': 4}, {'tx': 6, 'success': 1, 'collisions': 5}, {'tx': 5, 'success': 1, 'collisions': 4}, {'tx': 11, 'success': 4, 'collisions': 7}, {'tx': 7, 'success': 3, 'collisions': 4}]"
287,40,88,227,47,180,0.7929515418502202,0.20704845814977973,0.4136,"[{'tx': 3, 'success': 0, 'collisions': 3}, {'tx': 7, 'success': 2, 'collisions': 5}, {'tx': 4, 'success': 0, 'collisions': 4}, {'tx': 4, 'success': 0, 'collisions': 4}, {'tx': 4, 'success': 0, 'collisions': 4}, {'tx': 7, 'success': 1, 'collisions': 6}, {'tx': 4, 'success': 0, 'collisions': 4}, {'tx': 4, 'success': 0, 'collisions': 4}, {'tx': 8, 'success': 2, 'collisions': 6}, {'tx': 6, 'success': 2, 'collisions': 4}, {'tx': 4, 'success': 0, 'collisions': 4}, {'tx': 7, 'success': 2, 'collisions': 5}, {'tx': 8, 'success': 3, 'collisions': 5}, {'tx': 7, 'success': 2, 'collisions': 5}, {'tx': 5, 'success': 0, 'collisions': 5}, {'tx': 5, 'success': 1, 'collisions': 4}, {'tx': 14, 'success': 6, 'collisions': 8}, {'tx': 4, 'success': 0, 'collisions': 4}, {'tx': 4, 'success': 0, 'collisions': 4}, {'tx': 9, 'success': 3, 'collisions': 6}, {'tx': 7, 'success': 3, 'collisions': 4}, {'tx': 5, 'success': 0, 'collisions': 5}, {'tx': 9, 'success': 4, 'collisions': 5}, {'tx': 4, 'success': 1, 'collisions': 3}, {'tx': 3, 'success': 0, 'collisions': 3}, {'tx': 4, 'success': 0, 'collisions': 4}, {'tx': 4, 'success': 0, 'collisions': 4}, {'tx': 5, 'success': 0, 'collisions': 5}, {'tx': 3, 'success': 0, 'collisions': 3}, {'tx': 4, 'success': 0, 'collisions': 4}, {'tx': 8, 'success': 3, 'collisions': 5}, {'tx': 5, 'success': 1, 'collisions': 4}, {'tx': 4, 'success': 0, 'collisions': 4}, {'tx': 4, 'success': 0, 'collisions': 4}, {'tx': 10, 'success': 4, 'collisions': 6}, {'tx': 4, 'success': 0, 'collisions': 4}, {'tx': 12, 'success': 5, 'collisions': 7}, {'tx': 6, 'success': 1, 'collisions': 5}, {'tx': 5, 'success': 1, 'collisions': 4}, {'tx': 3, 'success': 0, 'collisions': 3}]"
288,40,89,218,46,172,0.7889908256880734,0.21100917431192662,0.4094,"[{'tx': 6, 'success': 1, 'collisions': 5}, {'tx': 4, 'success': 0, 'collisions': 4}, {'tx': 5, 'success': 0, 'collisions': 5}, {'tx': 4, 'success': 0, 'collisions': 4}, {'tx': 5, 'success': 1, 'collisions': 4}, {'tx': 7, 'success': 2, 'collisions': 5}, {'tx': 8, 'success': 2, 'collisions': 6}, {'tx': 3, 'success': 0, 'collisions': 3}, {'tx': 5, 'success': 1, 'collisions': 4}, {'tx': 3, 'success': 0, 'collisions': 3}, {'tx': 9, 'success': 4, 'collisions': 5}, {'tx': 6, 'success': 2, 'collisions': 4}, {'tx': 6, 'success': 2, 'collisions': 4}, {'tx': 3, 'success': 0, 'collisions': 3}, {'tx': 4, 'success': 0, 'collisions': 4}, {'tx': 4, 'success': 1, 'collisions': 3}, {'tx': 3, 'success': 0, 'collisions': 3}, {'tx': 4, 'success': 0, 'collisions': 4}, {'tx': 3, 'success': 0, 'collisions': 3}, {'tx': 4, 'success': 0, 'collisions': 4}, {'tx': 9, 'success': 3, 'collisions': 6}, {'tx': 6, 'success': 1, 'collisions': 5}, {'tx': 4, 'success': 0, 'collisions': 4}, {'tx': 6, 'success': 2, 'collisions': 4}, {'tx': 9, 'success': 3, 'collisions': 6}, {'tx': 6, 'success': 1, 'collisions': 5}, {'tx': 4, 'success': 0, 'collisions': 4}, {'tx': 3, 'success': 0, 'collisions': 3}, {'tx': 5, 'success': 1, 'collisions': 4}, {'tx': 6, 'success': 1, 'collisions': 5}, {'tx': 15, 'success': 7, 'collisions': 8}, {'tx': 4, 'success': 0, 'collisions': 4}, {'tx': 5, 'success': 0, 'collisions': 5}, {'tx': 9, 'success': 4, 'collisions': 5}, {'tx': 10, 'success': 5, 'collisions': 5}, {'tx': 3, 'success': 0, 'collisions': 3}, {'tx': 5, 'success': 1, 'collisions': 4}, {'tx': 5, 'success': 1, 'collisions': 4}, {'tx': 4, 'success': 0, 'collisions': 4}, {'tx': 4, 'success': 0, 'collisions': 4}]"
289,40,90,216,44,172,0.7962962962962963,0.2037037037037037,0.396,"[{'tx': 4, 'success': 0, 'collisions': 4}, {'tx': 9, 'success': 5, 'collisions': 4}, {'tx': 8, 'success': 3, 'collisions': 5}, {'tx': 4, 'success': 0, 'collisions': 4}, {'tx': 4, 'success': 0, 'collisions': 4}, {'tx': 5, 'success': 0, 'collisions': 5}, {'tx': 10, 'success': 3, 'collisions': 7}, {'tx': 3, 'success': 0, 'collisions': 3}, {'tx': 3, 'success': 0, 'collisions': 3}, {'tx': 6, 'success': 2, 'collisions': 4}, {'tx': 7, 'success': 4, 'collisions': 3}, {'tx': 3, 'success': 0, 'collisions': 3}, {'tx': 9, 'success': 4, 'collisions': 5}, {'tx': 10, 'success': 4, 'collisions': 6}, {'tx': 6, 'success': 1, 'collisions': 5}, {'tx': 7, 'success': 2, 'collisions': 5}, {'tx': 6, 'success': 1, 'collisions': 5}, {'tx': 6, 'success': 1, 'collisions': 5}, {'tx': 3, 'success': 0, 'collisions': 3}, {'tx': 3, 'success': 0, 'collisions': 3}, {'tx': 6, 'success': 1, 'collisions': 5}, {'tx': 4, 'success': 0, 'collisions': 4}, {'tx': 3, 'success': 0, 'collisions': 3}, {'tx': 5, 'success': 0, 'collisions': 5}, {'tx': 5, 'success': 0, 'collisions': 5}, {'tx': 7, 'success': 1, 'collisions': 6}, {'tx': 4, 'success': 0, 'collisions': 4}, {'tx': 4, 'success': 0, 'collisions': 4}, {'tx': 3, 'success': 0, 'collisions': 3}, {'tx': 7, 'success': 3, 'collisions': 4}, {'tx': 6, 'success': 1, 'collisions': 5}, {'tx': 6, 'success': 1, 'collisions': 5}, {'tx': 3, 'success': 0, 'collisions': 3}, {'tx': 3, 'success': 0, 'collisions': 3}, {'tx': 8, 'success': 2, 'collisions': 6}, {'tx': 8, 'success': 2, 'collisions': 6}, {'tx': 4, 'success': 0, 'collisions': 4}, {'tx': 7, 'success': 2, 'collisions': 5}, {'tx': 4, 'success': 1, 'collisions': 3}, {'tx': 3, 'success': 0, 'collisions': 3}]"
290,40,91,213,47,166,0.7793427230046949,0.22065727699530516,0.4277,"[{'tx': 8, 'success': 4, 'collisions': 4}, {'tx': 8, 'success': 3, 'collisions': 5}, {'tx': 7, 'success': 3, 'collisions': 4}, {'tx': 7, 'success': 2, 'collisions': 5}, {'tx': 9, 'success': 5, 'collisions': 4}, {'tx': 5, 'success': 1, 'collisions': 4}, {'tx': 4, 'success': 0, 'collisions': 4}, {'tx': 4, 'success': 0, 'collisions': 4}, {'tx': 4, 'success': 0, 'collisions': 4}, {'tx': 4, 'success': 0, 'collisions': 4}, {'tx': 5, 'success': 1, 'collisions': 4}, {'tx': 4, 'success': 0, 'collisions': 4}, {'tx': 6, 'success': 1, 'collisions': 5}, {'tx': 3, 'success': 0, 'collisions': 3}, {'tx': 4, 'success': 0, 'collisions': 4}, {'tx': 6, 'success': 1, 'collisions': 5}, {'tx': 4, 'success': 1, 'collisions': 3}, {'tx': 5, 'success': 1, 'collisions': 4}, {'tx': 3, 'success': 0, 'collisions': 3}, {'tx': 6, 'success': 2, 'collisions': 4}, {'tx': 7, 'success': 3, 'collisions': 4}, {'tx': 4, 'success': 0, 'collisions': 4}, {'tx': 4, 'success': 0, 'collisions': 4}, {'tx': 5, 'success': 1, 'collisions': 4}, {'tx': 8, 'success': 2, 'collisions': 6}, {'tx': 3, 'success': 0, 'collisions': 3}, {'tx': 7, 'success': 1, 'collisions': 6}, {'tx': 7, 'success': 2, 'collisions': 5}, {'tx': 6, 'success': 1, 'collisions': 5}, {'tx': 3, 'success': 0, 'collisions': 3}, {'tx': 4, 'success': 0, 'collisions': 4}, {'tx': 7, 'success': 2, 'collisions': 5}, {'tx': 3, 'success': 0, 'collisions': 3}, {'tx': 8, 'success': 3, 'collisions': 5}, {'tx': 4, 'success': 0, 'collisions': 4}, {'tx': 6, 'success': 1, 'collisions': 5}, {'tx': 7, 'success': 3, 'collisions': 4}, {'tx': 4, 'success': 1, 'collisions': 3}, {'tx': 6, 'success': 2, 'collisions': 4}, {'tx': 4, 'success': 0, 'collisions': 4}]"
291,40,92,219,51,168,0.7671232876712328,0.2328767123287671,0.4692,"[{'tx': 4, 'success': 0, 'collisions': 4}, {'tx': 5, 'success': 1, 'collisions': 4}, {'tx': 5, 'success': 1, 'collisions': 4}, {'tx': 5, 'success': 1, 'collisions': 4}, {'tx': 3, 'success': 0, 'collisions': 3}, {'tx': 6, 'success': 1, 'collisions': 5}, {'tx': 10, 'success': 6, 'collisions': 4}, {'tx': 4, 'success': 0, 'collisions': 4}, {'tx': 3, 'success': 0, 'collisions': 3}, {'tx': 4, 'success': 0, 'collisions': 4}, {'tx': 3, 'success': 0, 'collisions': 3}, {'tx': 7, 'success': 3, 'collisions': 4}, {'tx': 4, 'success': 0, 'collisions': 4}, {'tx': 3, 'success': 0, 'collisions': 3}, {'tx': 4, 'success': 0, 'collisions': 4}, {'tx': 5, 'success': 1, 'collisions': 4}, {'tx': 5, 'success': 0, 'collisions': 5}, {'tx': 17, 'success': 11, 'collisions': 6}, {'tx': 7, 'success': 1, 'collisions': 6}, {'tx': 5, 'success': 1, 'collisions': 4}, {'tx': 4, 'success': 0, 'collisions': 4}, {'tx': 6, 'success': 1, 'collisions': 5}, {'tx': 6, 'success': 2, 'collisions': 4}, {'tx': 4, 'success': 0, 'collisions': 4}, {'tx': 11, 'success': 6, 'collisions': 5}, {'tx': 3, 'success': 0, 'collisions': 3}, {'tx': 8, 'success': 2, 'collisions': 6}, {'tx': 4, 'success': 0, 'collisions': 4}, {'tx': 3, 'success': 0, 'collisions': 3}, {'tx': 7, 'success': 2, 'collisions': 5}, {'tx': 6, 'success': 1, 'collisions': 5}, {'tx': 8, 'success': 3, 'collisions': 5}, {'tx': 5, 'success': 0, 'collisions': 5}, {'tx': 4, 'success': 1, 'collisions': 3}, {'tx': 3, 'success': 0, 'collisions': 3}, {'tx': 5, 'success': 0, 'collisions': 5}, {'tx': 13, 'success': 5, 'collisions': 8}, {'tx': 3, 'success': 0, 'collisions': 3}, {'tx': 4, 'success': 1, 'collisions': 3}, {'tx': 3, 'success': 0, 'collisions': 3}]"
292,40,93,220,48,172,0.7818181818181819,0.21818181818181817,0.4464,"[{'tx': 8, 'success': 3, 'collisions': 5}, {'tx': 6, 'success': 1, 'collisions': 5}, {'tx': 6, 'success': 1, 'collisions': 5}, {'tx': 7, 'success': 2, 'collisions': 5}, {'tx': 9, 'success': 4, 'collisions': 5}, {'tx': 4, 'success': 1, 'collisions': 3}, {'tx': 8, 'success': 2, 'collisions': 6}, {'tx': 6, 'success': 1, 'collisions': 5}, {'tx': 3, 'success': 0, 'collisions': 3}, {'tx': 4, 'success': 0, 'collisions': 4}, {'tx': 4, 'success': 0, 'collisions': 4}, {'tx': 3, 'success': 0, 'collisions': 3}, {'tx': 4, 'success': 0, 'collisions': 4}, {'tx': 4, 'success': 0, 'collisions': 4}, {'tx': 4, 'success': 0, 'collisions': 4}, {'tx': 3, 'success': 0, 'collisions': 3}, {'tx': 4, 'success': 0, 'collisions': 4}, {'tx': 3, 'success': 0, 'collisions': 3}, {'tx': 3, 'success': 0, 'collisions': 3}, {'tx': 10, 'success': 3, 'collisions': 7}, {'tx': 4, 'success': 0, 'collisions': 4}, {'tx': 7, 'success': 3, 'collisions': 4}, {'tx': 3, 'success': 0, 'collisions': 3}, {'tx': 7, 'success': 1, 'collisions': 6}, {'tx': 8, 'success': 2, 'collisions': 6}, {'tx': 5, 'success': 1, 'collisions': 4}, {'tx': 5, 'success': 1, 'collisions': 4}, {'tx': 11, 'success': 5, 'collisions': 6}, {'tx': 4, 'success': 0, 'collisions': 4}, {'tx': 3, 'success': 0, 'collisions': 3}, {'tx': 5, 'success': 1, 'collisions': 4}, {'tx': 8, 'success': 4, 'collisions': 4}, {'tx': 9, 'success': 4, 'collisions': 5}, {'tx': 4, 'success': 0, 'collisions': 4}, {'tx': 7, 'success': 1, 'collisions': 6}, {'tx': 6, 'success': 3, 'collisions': 3}, {'tx': 8, 'success': 3, 'collisions': 5}, {'tx': 3, 'success': 0, 'collisions': 3}, {'tx': 5, 'success': 1, 'collisions': 4}, {'tx': 5, 'success': 0, 'collisions': 5}]"
293,40,94,219,46,173,0.7899543378995434,0.2100456621004566,0.4324,"[{'tx': 11, 'success': 4, 'collisions': 7}, {'tx': 8, 'success': 4, 'collisions': 4}, {'tx': 5, 'success': 1, 'collisions': 4}, {'tx': 4, 'success': 0, 'collisions': 4}, {'tx': 3, 'success': 0, 'collisions': 3}, {'tx': 4, 'success': 0, 'collisions': 4}, {'tx': 7, 'success': 2, 'collisions': 5}, {'tx': 7, 'success': 3, 'collisions': 4}, {'tx': 4, 'success': 0, 'collisions': 4}, {'tx': 5, 'success': 1, 'collisions': 4}, {'tx': 4, 'success': 0, 'collisions': 4}, {'tx': 8, 'success': 2, 'collisions': 6}, {'tx': 5, 'success': 2, 'collisions': 3}, {'tx': 7, 'success': 3, 'collisions': 4}, {'tx': 5, 'success': 1, 'collisions': 4}, {'tx': 3, 'success': 0, 'collisions': 3}, {'tx': 3, 'success': 0, 'collisions': 3}, {'tx': 3, 'success': 0, 'collisions': 3}, {'tx': 4, 'success': 0, 'collisions': 4}, {'tx': 7, 'success': 2, 'collisions': 5}, {'tx': 4, 'success': 0, 'collisions': 4}, {'tx': 4, 'success': 0, 'collisions': 4}, {'tx': 3, 'success': 0, 'collisions': 3}, {'tx': 7, 'success': 2, 'collisions': 5}, {'tx': 6, 'success': 1, 'collisions': 5}, {'tx': 9, 'success': 3, 'collisions': 6}, {'tx': 10, 'success': 3, 'collisions': 7}, {'tx': 4, 'success': 0, 'collisions': 4}, {'tx': 7, 'success': 2, 'collisions': 5}, {'tx': 4, 'success': 0, 'collisions': 4}, {'tx': 3, 'success': 0, 'collisions': 3}, {'tx': 4, 'success': 0, 'collisions': 4}, {'tx': 4, 'success': 1, 'collisions': 3}, {'tx': 9, 'success': 4, 'collisions': 5}, {'tx': 6, 'success': 1, 'collisions': 5}, {'tx': 6, 'success': 1, 'collisions': 5}, {'tx': 5, 'success': 0, 'collisions': 5}, {'tx': 3, 'success': 0, 'collisions': 3}, {'tx': 8, 'success': 2, 'collisions': 6}, {'tx': 6, 'success': 1, 'collisions': 5}]"
294,40,95,212,46,166,0.7830188679245284,0.2169811320754717,0.437,"[{'tx': 4, 'success': 0, 'collisions': 4}, {'tx': 3, 'success': 0, 'collisions': 3}, {'tx': 6, 'success': 1, 'collisions': 5}, {'tx': 4, 'success': 0, 'collisions': 4}, {'tx': 11, 'success': 4, 'collisions': 7}, {'tx': 4, 'success': 0, 'collisions': 4}, {'tx': 6, 'success': 2, 'collisions': 4}, {'tx': 3, 'success': 0, 'collisions': 3}, {'tx': 4, 'success': 0, 'collisions': 4}, {'tx': 8, 'success': 2, 'collisions': 6}, {'tx': 3, 'success': 0, 'collisions': 3}, {'tx': 7, 'success': 3, 'collisions': 4}, {'tx': 7, 'success': 3, 'collisions': 4}, {'tx': 4, 'success': 1, 'collisions': 3}, {'tx': 11, 'success': 5, 'collisions': 6}, {'tx': 4, 'success': 0, 'collisions': 4}, {'tx': 3, 'success': 0, 'collisions': 3}, {'tx': 7, 'success': 1, 'collisions': 6}, {'tx': 8, 'success': 2, 'collisions': 6}, {'tx': 4, 'success': 1, 'collisions': 3}, {'tx': 3, 'success': 0, 'collisions': 3}, {'tx': 4, 'success': 0, 'collisions': 4}, {'tx': 9, 'success': 4, 'collisions': 5}, {'tx': 6, 'success': 2, 'collisions': 4}, {'tx': 4, 'success': 0, 'collisions': 4}, {'tx': 4, 'success': 1, 'collisions': 3}, {'tx': 4, 'success': 0, 'collisions': 4}, {'tx': 4, 'success': 0, 'collisions': 4}, {'tx': 6, 'success': 2, 'collisions': 4}, {'tx': 4, 'success': 0, 'collisions': 4}, {'tx': 9, 'success': 5, 'collisions': 4}, {'tx': 3, 'success': 0, 'collisions': 3}, {'tx': 5, 'success': 0, 'collisions': 5}, {'tx': 4, 'success': 0, 'collisions': 4}, {'tx': 5, 'success': 0, 'collisions': 5}, {'tx': 4, 'success': 0, 'collisions': 4}, {'tx': 7, 'success': 3, 'collisions': 4}, {'tx': 4, 'success': 0, 'collisions': 4}, {'tx': 4, 'success': 1, 'collisions': 3}, {'tx': 8, 'success': 3, 'collisions': 5}]"
295,40,96,222,42,180,0.8108108108108109,0.1891891891891892,0.4032,"[{'tx': 6, 'success': 1, 'collisions': 5}, {'tx': 4, 'success': 0, 'collisions': 4}, {'tx': 12, 'success': 4, 'collisions': 8}, {'tx': 4, 'success': 0, 'collisions': 4}, {'tx': 6, 'success': 1, 'collisions': 5}, {'tx': 3, 'success': 0, 'collisions': 3}, {'tx': 6, 'success': 1, 'collisions': 5}, {'tx': 8, 'success': 3, 'collisions': 5}, {'tx': 4, 'success': 0, 'collisions': 4}, {'tx': 6, 'success': 1, 'collisions': 5}, {'tx': 8, 'success': 2, 'collisions': 6}, {'tx': 10, 'success': 4, 'collisions': 6}, {'tx': 3, 'success': 0, 'collisions': 3}, {'tx': 4, 'success': 0, 'collisions': 4}, {'tx': 3, 'success': 0, 'collisions': 3}, {'tx': 10, 'success': 4, 'collisions': 6}, {'tx': 8, 'success': 3, 'collisions': 5}, {'tx': 7, 'success': 2, 'collisions': 5}, {'tx': 5, 'success': 1, 'collisions': 4}, {'tx': 4, 'success': 0, 'collisions': 4}, {'tx': 4, 'success': 0, 'collisions': 4}, {'tx': 4, 'success': 0, 'collisions': 4}, {'tx': 4, 'success': 0, 'collisions': 4}, {'tx': 4, 'success': 0, 'collisions': 4}, {'tx': 7, 'success': 1, 'collisions': 6}, {'tx': 6, 'success': 2, 'collisions': 4}, {'tx': 4, 'success': 0, 'collisions': 4}, {'tx': 9, 'success': 3, 'collisions': 6}, {'tx': 4, 'success': 0, 'collisions': 4}, {'tx': 8, 'success': 2, 'collisions': 6}, {'tx': 7, 'success': 3, 'collisions': 4}, {'tx': 4, 'success': 0, 'collisions': 4}, {'tx': 7, 'success': 2, 'collisions': 5}, {'tx': 4, 'success': 0, 'collisions': 4}, {'tx': 4, 'success': 0, 'collisions': 4}, {'tx': 4, 'success': 0, 'collisions': 4}, {'tx': 5, 'success': 1, 'collisions': 4}, {'tx': 4, 'success': 0, 'collisions': 4}, {'tx': 5, 'success': 1, 'collisions': 4}, {'tx': 3, 'success': 0, 'collisions': 3}]"
296,40,97,206,46,160,0.7766990291262136,0.22330097087378642,0.4462,"[{'tx': 6, 'success': 1, 'collisions': 5}, {'tx': 6, 'success': 1, 'collisions': 5}, {'tx': 10, 'success': 4, 'collisions': 6}, {'tx': 6, 'success': 2, 'collisions': 4}, {'tx': 4, 'success': 1, 'collisions': 3}, {'tx': 6, 'success': 1, 'collisions': 5}, {'tx': 7, 'success': 1, 'collisions': 6}, {'tx': 9, 'success': 5, 'collisions': 4}, {'tx': 4, 'success': 0, 'collisions': 4}, {'tx': 3, 'success': 0, 'collisions': 3}, {'tx': 3, 'success': 0, 'collisions': 3}, {'tx': 6, 'success': 1, 'collisions': 5}, {'tx': 3, 'success': 0, 'collisions': 3}, {'tx': 3, 'success': 0, 'collisions': 3}, {'tx': 3, 'success': 0, 'collisions': 3}, {'tx': 9, 'success': 5, 'collisions': 4}, {'tx': 9, 'success': 5, 'collisions': 4}, {'tx': 4, 'success': 0, 'collisions': 4}, {'tx': 4, 'success': 0, 'collisions': 4}, {'tx': 4, 'success': 0, 'collisions': 4}, {'tx': 4, 'success': 1, 'collisions': 3}, {'tx': 3, 'success': 0, 'collisions': 3}, {'tx': 4, 'success': 0, 'collisions': 4}, {'tx': 3, 'success': 0, 'collisions': 3}, {'tx': 3, 'success': 0, 'collisions': 3}, {'tx': 5, 'success': 2, 'collisions': 3}, {'tx': 4, 'success': 0, 'collisions': 4}, {'tx': 9, 'success': 3, 'collisions': 6}, {'tx': 4, 'success': 0, 'collisions': 4}, {'tx': 3, 'success': 0, 'collisions': 3}, {'tx': 5, 'success': 1, 'collisions': 4}, {'tx': 7, 'success': 2, 'collisions': 5}, {'tx': 3, 'success': 0, 'collisions': 3}, {'tx': 7, 'success': 3, 'collisions': 4}, {'tx': 6, 'success': 1, 'collisions': 5}, {'tx': 8, 'success': 2, 'collisions': 6}, {'tx': 3, 'success': 0, 'collisions': 3}, {'tx': 5, 'success': 1, 'collisions': 4}, {'tx': 3, 'success': 0, 'collisions': 3}, {'tx': 8, 'success': 3, 'collisions': 5}]"
297,40,98,200,46,154,0.77,0.23,0.4508,"[{'tx': 3, 'success': 0, 'collisions': 3}, {'tx': 8, 'success': 2, 'collisions': 6}, {'tx': 4, 'success': 1, 'collisions': 3}, {'tx': 8, 'success': 3, 'collisions': 5}, {'tx': 7, 'success': 1, 'collisions': 6}, {'tx': 4, 'success': 0, 'collisions': 4}, {'tx': 5, 'success': 1, 'collisions': 4}, {'tx': 5, 'success': 1, 'collisions': 4}, {'tx': 5, 'success': 1, 'collisions': 4}, {'tx': 4, 'success': 0, 'collisions': 4}, {'tx': 7, 'success': 1, 'collisions': 6}, {'tx': 3, 'success': 0, 'collisions': 3}, {'tx': 3, 'success': 0, 'collisions': 3}, {'tx': 7, 'success': 3, 'collisions': 4}, {'tx': 4, 'success': 0, 'collisions': 4}, {'tx': 7, 'success': 3, 'collisions': 4}, {'tx': 3, 'success': 0, 'collisions': 3}, {'tx': 4, 'success': 0, 'collisions': 4}, {'tx': 7, 'success': 3, 'collisions': 4}, {'tx': 7, 'success': 1, 'collisions': 6}, {'tx': 5, 'success': 2, 'collisions': 3}, {'tx': 5, 'success': 1, 'collisions': 4}, {'tx': 3, 'success': 0, 'collisions': 3}, {'tx': 3, 'success': 0, 'collisions': 3}, {'tx': 6, 'success': 2, 'collisions': 4}, {'tx': 3, 'success': 0, 'collisions': 3}, {'tx': 3, 'success': 0, 'collisions': 3}, {'tx': 5, 'success': 1, 'collisions': 4}, {'tx': 3, 'success': 0, 'collisions': 3}, {'tx': 6, 'success': 3, 'collisions': 3}, {'tx': 9, 'success': 5, 'collisions': 4}, {'tx': 7, 'success': 3, 'collisions': 4}, {'tx': 4, 'success': 0, 'collisions': 4}, {'tx': 7, 'success': 3, 'collisions': 4}, {'tx': 7, 'success': 4, 'collisions': 3}, {'tx': 3, 'success': 0, 'collisions': 3}, {'tx': 4, 'success': 0, 'collisions': 4}, {'tx': 4, 'success': 0, 'collisions': 4}, {'tx': 3, 'success': 0, 'collisions': 3}, {'tx': 5, 'success': 1, 'collisions': 4}]"
298,40,99,201,39,162,0.8059701492537313,0.19402985074626866,0.3861,"[{'tx': 4, 'success': 0, 'collisions': 4}, {'tx': 4, 'success': 0, 'collisions': 4}, {'tx': 4, 'success': 0, 'collisions': 4}, {'tx': 4, 'success': 0, 'collisions': 4}, {'tx': 3, 'success': 0, 'collisions': 3}, {'tx': 4, 'success': 0, 'collisions': 4}, {'tx': 4, 'success': 0, 'collisions': 4}, {'tx': 3, 'success': 0, 'collisions': 3}, {'tx': 4, 'success': 0, 'collisions': 4}, {'tx': 6, 'success': 2, 'collisions': 4}, {'tx': 4, 'success': 0, 'collisions': 4}, {'tx': 3, 'success': 0, 'collisions': 3}, {'tx': 3, 'success': 0, 'collisions': 3}, {'tx': 4, 'success': 0, 'collisions': 4}, {'tx': 3, 'success': 0, 'collisions': 3}, {'tx': 7, 'success': 1, 'collisions': 6}, {'tx': 6, 'success': 3, 'collisions': 3}, {'tx': 11, 'success': 4, 'collisions': 7}, {'tx': 7, 'success': 2, 'collisions': 5}, {'tx': 3, 'success': 0, 'collisions': 3}, {'tx': 6, 'success': 2, 'collisions': 4}, {'tx': 4, 'success': 0, 'collisions': 4}, {'tx': 5, 'success': 2, 'collisions': 3}, {'tx': 3, 'success': 0, 'collisions': 3}, {'tx': 4, 'success': 0, 'collisions': 4}, {'tx': 6, 'success': 3, 'collisions': 3}, {'tx': 6, 'success': 1, 'collisions': 5}, {'tx': 5, 'success': 1, 'collisions': 4}, {'tx': 5, 'success': 0, 'collisions': 5}, {'tx': 7, 'success': 3, 'collisions': 4}, {'tx': 3, 'success': 0, 'collisions': 3}, {'tx': 9, 'success': 4, 'collisions': 5}, {'tx': 9, 'success': 3, 'collisions': 6}, {'tx': 4, 'success': 0, 'collisions': 4}, {'tx': 11, 'success': 5, 'collisions': 6}, {'tx': 5, 'success': 1, 'collisions': 4}, {'tx': 4, 'success': 0, 'collisions': 4}, {'tx': 3, 'success': 0, 'collisions': 3}, {'tx': 5, 'success': 1, 'collisions': 4}, {'tx': 6, 'success': 1, 'collisions': 5}]"
299,40,100,203,37,166,0.8177339901477833,0.18226600985221675,0.37,"[{'tx': 8, 'success': 2, 'collisions': 6}, {'tx': 5, 'success': 1, 'collisions': 4}, {'tx': 9, 'success': 4, 'collisions': 5}, {'tx': 6, 'success': 1, 'collisions': 5}, {'tx': 5, 'success': 2, 'collisions': 3}, {'tx': 3, 'success': 0, 'collisions': 3}, {'tx': 3, 'success': 0, 'collisions': 3}, {'tx': 4, 'success': 0, 'collisions': 4}, {'tx': 5, 'success': 2, 'collisions': 3}, {'tx': 8, 'success': 4, 'collisions': 4}, {'tx': 6, 'success': 1, 'collisions': 5}, {'tx': 3, 'success': 0, 'collisions': 3}, {'tx': 3, 'success': 0, 'collisions': 3}, {'tx': 6, 'success': 2, 'collisions': 4}, {'tx': 3, 'success': 0, 'collisions': 3}, {'tx': 6, 'success': 1, 'collisions': 5}, {'tx': 3, 'success': 0, 'collisions': 3}, {'tx': 5, 'success': 1, 'collisions': 4}, {'tx': 3, 'success': 0, 'collisions': 3}, {'tx': 3, 'success': 0, 'collisions': 3}, {'tx': 4, 'success': 0, 'collisions': 4}, {'tx': 7, 'success': 1, 'collisions': 6}, {'tx': 3, 'success': 0, 'collisions': 3}, {'tx': 4, 'success': 0, 'collisions': 4}, {'tx': 4, 'success': 0, 'collisions': 4}, {'tx': 8, 'success': 4, 'collisions': 4}, {'tx': 9, 'success': 3, 'collisions': 6}, {'tx': 6, 'success': 1, 'collisions': 5}, {'tx': 4, 'success': 0, 'collisions': 4}, {'tx': 9, 'success': 2, 'collisions': 7}, {'tx': 10, 'success': 3, 'collisions': 7}, {'tx': 7, 'success': 1, 'collisions': 6}, {'tx': 4, 'success': 0, 'collisions': 4}, {'tx': 7, 'success': 1, 'collisions': 6}, {'tx': 3, 'success': 0, 'collisions': 3}, {'tx': 3, 'success': 0, 'collisions': 3}, {'tx': 3, 'success': 0, 'collisions': 3}, {'tx': 3, 'success': 0, 'collisions': 3}, {'tx': 3, 'success': 0, 'collisions': 3}, {'tx': 5, 'success': 0, 'collisions': 5}]"
